fips,state,year,pop,clf,pc_clf,emp,pc_emp,unem,unem_rate
1,Alabama,1976,2632667,1499637,57.0,1398848,53.1,100789,6.7
2,Alaska,1976,239917,164014,68.4,151501,63.1,12513,7.6
4,Arizona,1976,1650917,981368,59.4,885146,53.6,96222,9.8
5,Arkansas,1976,1546583,893588,57.8,831795,53.8,61793,6.9
6,California,1976,15823750,9894236,62.5,8985601,56.8,908635,9.2
8,Colorado,1976,1858250,1240720,66.8,1166629,62.8,74091,6.0
9,Connecticut,1976,2260083,1452948,64.3,1319169,58.4,133779,9.2
10,Delaware,1976,420667,263254,62.6,240758,57.2,22496,8.5
11,District of Columbia,1976,517250,332191,64.2,303412,58.7,28779,8.7
12,Florida,1976,6509000,3599977,55.3,3264198,50.1,335779,9.3
13,Georgia,1976,3557750,2269768,63.8,2084229,58.6,185539,8.2
15,Hawaii,1976,591833,409430,69.2,371732,62.8,37698,9.2
16,Idaho,1976,589333,372098,63.1,351095,59.6,21003,5.6
17,Illinois,1976,8177500,5146173,62.9,4809580,58.8,336593,6.5
18,Indiana,1976,3812500,2438803,64.0,2290297,60.1,148506,6.1
19,Iowa,1976,2081583,1338397,64.3,1283262,61.6,55135,4.1
20,Kansas,1976,1647583,1076433,65.3,1031811,62.6,44622,4.1
21,Kentucky,1976,2486500,1492853,60.0,1411467,56.8,81386,5.5
22,Louisiana,1976,2707250,1531021,56.6,1429726,52.8,101295,6.6
23,Maine,1976,772833,476205,61.6,434901,56.3,41304,8.7
24,Maryland,1976,2977417,1912980,64.2,1787458,60.0,125522,6.6
25,Massachusetts,1976,4212167,2727872,64.8,2461279,58.4,266593,9.8
26,Michigan,1976,6453167,3983724,61.7,3608668,55.9,375056,9.4
27,Minnesota,1976,2812250,1849935,65.8,1741994,61.9,107941,5.8
28,Mississippi,1976,1657167,970283,58.6,906817,54.7,63466,6.5
29,Missouri,1976,3486917,2122215,60.9,1990786,57.1,131429,6.2
30,Montana,1976,536667,334867,62.4,315140,58.7,19727,5.9
31,Nebraska,1976,1101167,716700,65.1,693836,63.0,22864,3.2
32,Nevada,1976,463417,327947,70.8,298870,64.5,29077,8.9
33,New Hampshire,1976,602000,398463,66.2,372873,61.9,25590,6.4
34,New Jersey,1976,5382750,3318992,61.7,2974012,55.3,344980,10.4
35,New Mexico,1976,808000,488114,60.4,445718,55.2,42396,8.7
36,New York,1976,13221750,7675128,58.0,6889938,52.1,785190,10.2
37,North Carolina,1976,3937333,2606423,66.2,2443938,62.1,162485,6.2
38,North Dakota,1976,446250,280192,62.8,269663,60.4,10529,3.8
39,Ohio,1976,7731000,4753379,61.5,4384260,56.7,369119,7.8
40,Oklahoma,1976,2020583,1191850,59.0,1124921,55.7,66929,5.6
41,Oregon,1976,1739583,1095663,63.0,993544,57.1,102119,9.3
42,Pennsylvania,1976,8807167,5137714,58.3,4726485,53.7,411229,8.0
44,Rhode Island,1976,695750,441339,63.4,405977,58.4,35362,8.0
45,South Carolina,1976,2007417,1299241,64.7,1207662,60.2,91579,7.0
46,South Dakota,1976,480583,310416,64.6,300051,62.4,10365,3.3
47,Tennessee,1976,3112917,1858503,59.7,1744984,56.1,113519,6.1
48,Texas,1976,8957667,5702276,63.7,5370958,60.0,331318,5.8
49,Utah,1976,836417,524870,62.8,495389,59.2,29481,5.6
50,Vermont,1976,342917,217719,63.5,199700,58.2,18019,8.3
51,Virginia,1976,3578083,2341052,65.4,2202791,61.6,138261,5.9
53,Washington,1976,2633667,1616274,61.4,1474237,56.0,142037,8.8
54,West Virginia,1976,1366917,707874,51.8,656870,48.1,51004,7.2
55,Wisconsin,1976,3266333,2144634,65.7,2025880,62.0,118754,5.5
56,Wyoming,1976,275500,180343,65.5,173379,62.9,6964,3.9
1,Alabama,1977,2688917,1564045,58.2,1452319,54.0,111726,7.1
2,Alaska,1977,248083,173460,69.9,156401,63.0,17059,9.8
4,Arizona,1977,1726250,1043373,60.4,955867,55.4,87506,8.4
5,Arkansas,1977,1581917,924959,58.5,865033,54.7,59926,6.5
6,California,1977,16277917,10377705,63.8,9509331,58.4,868374,8.4
8,Colorado,1977,1923667,1294484,67.3,1212765,63.0,81719,6.3
9,Connecticut,1977,2286000,1484819,65.0,1381070,60.4,103749,7.0
10,Delaware,1977,428583,272136,63.5,249856,58.3,22280,8.2
11,District of Columbia,1977,512500,327833,64.0,299598,58.5,28235,8.6
12,Florida,1977,6720167,3725786,55.4,3417597,50.9,308189,8.3
13,Georgia,1977,3646333,2329388,63.9,2167738,59.4,161650,6.9
15,Hawaii,1977,608917,416725,68.4,384816,63.2,31909,7.7
16,Idaho,1977,611000,396993,65.0,373744,61.2,23249,5.9
17,Illinois,1977,8280750,5286829,63.8,4959918,59.9,326911,6.2
18,Indiana,1977,3868417,2485126,64.2,2341757,60.5,143369,5.8
19,Iowa,1977,2109250,1386049,65.7,1330521,63.1,55528,4.0
20,Kansas,1977,1673667,1109756,66.3,1066824,63.7,42932,3.9
21,Kentucky,1977,2538167,1538019,60.6,1463772,57.7,74247,4.8
22,Louisiana,1977,2775417,1601844,57.7,1490685,53.7,111159,6.9
23,Maine,1977,790083,480462,60.8,440259,55.7,40203,8.4
24,Maryland,1977,3030250,1970596,65.0,1850351,61.1,120245,6.1
25,Massachusetts,1977,4254167,2753969,64.7,2537669,59.7,216300,7.9
26,Michigan,1977,6543083,4107931,62.8,3769992,57.6,337939,8.2
27,Minnesota,1977,2861667,1920172,67.1,1818875,63.6,101297,5.3
28,Mississippi,1977,1690583,994117,58.8,922551,54.6,71566,7.2
29,Missouri,1977,3535000,2203928,62.3,2072105,58.6,131823,6.0
30,Montana,1977,550500,349017,63.4,327531,59.5,21486,6.2
31,Nebraska,1977,1114417,740155,66.4,715380,64.2,24775,3.3
32,Nevada,1977,492500,350565,71.2,326885,66.4,23680,6.8
33,New Hampshire,1977,625667,419025,67.0,395736,63.3,23289,5.6
34,New Jersey,1977,5436833,3384570,62.3,3069806,56.5,314764,9.3
35,New Mexico,1977,838583,511996,61.1,472280,56.3,39716,7.8
36,New York,1977,13244083,7732196,58.4,7023233,53.0,708963,9.2
37,North Carolina,1977,4027333,2684559,66.7,2526578,62.7,157981,5.9
38,North Dakota,1977,453417,288672,63.7,275868,60.8,12804,4.4
39,Ohio,1977,7812167,4831651,61.8,4518963,57.8,312688,6.5
40,Oklahoma,1977,2065583,1239233,60.0,1180130,57.1,59103,4.8
41,Oregon,1977,1800333,1152680,64.0,1066882,59.3,85798,7.4
42,Pennsylvania,1977,8879000,5213501,58.7,4810471,54.2,403030,7.7
44,Rhode Island,1977,706083,448980,63.6,412846,58.5,36134,8.0
45,South Carolina,1977,2061250,1327423,64.4,1237495,60.0,89928,6.8
46,South Dakota,1977,486583,317368,65.2,306651,63.0,10717,3.4
47,Tennessee,1977,3188167,1938641,60.8,1817186,57.0,121455,6.3
48,Texas,1977,9243167,5963036,64.5,5639671,61.0,323365,5.4
49,Utah,1977,866000,546274,63.1,517776,59.8,28498,5.2
50,Vermont,1977,351583,227941,64.8,211955,60.3,15986,7.0
51,Virginia,1977,3667667,2403064,65.5,2272097,61.9,130967,5.5
53,Washington,1977,2719000,1705073,62.7,1562363,57.5,142710,8.4
54,West Virginia,1977,1394583,718951,51.6,669206,48.0,49745,6.9
55,Wisconsin,1977,3319417,2187485,65.9,2077068,62.6,110417,5.0
56,Wyoming,1977,288833,195129,67.6,188768,65.4,6361,3.3
1,Alabama,1978,2745083,1621598,59.1,1517226,55.3,104372,6.4
2,Alaska,1978,255000,182114,71.4,162630,63.8,19484,10.7
4,Arizona,1978,1809083,1083594,59.9,1019132,56.3,64462,5.9
5,Arkansas,1978,1616250,948231,58.7,889143,55.0,59088,6.2
6,California,1978,16761667,10910577,65.1,10131743,60.4,778834,7.1
8,Colorado,1978,1994750,1354526,67.9,1279264,64.1,75262,5.6
9,Connecticut,1978,2312833,1512462,65.4,1432270,61.9,80192,5.3
10,Delaware,1978,434750,277228,63.8,257615,59.3,19613,7.1
11,District of Columbia,1978,508750,332282,65.3,306402,60.2,25880,7.8
12,Florida,1978,6970583,3968971,56.9,3701085,53.1,267886,6.7
13,Georgia,1978,3732167,2408232,64.5,2271148,60.9,137084,5.7
15,Hawaii,1978,624167,421466,67.5,392252,62.8,29214,6.9
16,Idaho,1978,631667,414990,65.7,392150,62.1,22840,5.5
17,Illinois,1978,8365417,5423786,64.8,5098246,60.9,325540,6.0
18,Indiana,1978,3928917,2584346,65.8,2440637,62.1,143709,5.6
19,Iowa,1978,2129333,1415772,66.5,1360894,63.9,54878,3.9
20,Kansas,1978,1697750,1135822,66.9,1101149,64.9,34673,3.1
21,Kentucky,1978,2581583,1577833,61.1,1497930,58.0,79903,5.1
22,Louisiana,1978,2836500,1668892,58.8,1554999,54.8,113893,6.8
23,Maine,1978,805333,485686,60.3,454521,56.4,31165,6.4
24,Maryland,1978,3076917,2049194,66.6,1934304,62.9,114890,5.6
25,Massachusetts,1978,4297167,2813196,65.5,2639856,61.4,173340,6.2
26,Michigan,1978,6634500,4220095,63.6,3923236,59.1,296859,7.0
27,Minnesota,1978,2907500,1976473,68.0,1899022,65.3,77451,3.9
28,Mississippi,1978,1722000,1010650,58.7,942275,54.7,68375,6.8
29,Missouri,1978,3581750,2263749,63.2,2152914,60.1,110835,4.9
30,Montana,1978,564667,364001,64.5,343753,60.9,20248,5.6
31,Nebraska,1978,1127167,752051,66.7,729647,64.7,22404,3.0
32,Nevada,1978,528750,373572,70.7,357075,67.5,16497,4.4
33,New Hampshire,1978,647833,435252,67.2,418634,64.6,16618,3.8
34,New Jersey,1978,5497917,3460776,62.9,3210049,58.4,250727,7.2
35,New Mexico,1978,866417,531179,61.3,498329,57.5,32850,6.2
36,New York,1978,13252750,7846338,59.2,7241276,54.6,605062,7.7
37,North Carolina,1978,4113167,2763559,67.2,2637518,64.1,126041,4.6
38,North Dakota,1978,458750,295165,64.3,282869,61.7,12296,4.2
39,Ohio,1978,7891000,4953330,62.8,4680003,59.3,273327,5.5
40,Oklahoma,1978,2112167,1269116,60.1,1226638,58.1,42478,3.3
41,Oregon,1978,1862167,1208992,64.9,1135451,61.0,73541,6.1
42,Pennsylvania,1978,8938917,5302387,59.3,4931079,55.2,371308,7.0
44,Rhode Island,1978,714333,450484,63.1,422048,59.1,28436,6.3
45,South Carolina,1978,2117667,1356921,64.1,1281597,60.5,75324,5.6
46,South Dakota,1978,490000,322731,65.9,312491,63.8,10240,3.2
47,Tennessee,1978,3254167,1976356,60.7,1861405,57.2,114951,5.8
48,Texas,1978,9535417,6228322,65.3,5922294,62.1,306028,4.9
49,Utah,1978,896750,569213,63.5,547137,61.0,22076,3.9
50,Vermont,1978,359833,238051,66.2,224572,62.4,13479,5.7
51,Virginia,1978,3755667,2485923,66.2,2354830,62.7,131093,5.3
53,Washington,1978,2823333,1810817,64.1,1687119,59.8,123698,6.8
54,West Virginia,1978,1412667,735448,52.1,688764,48.8,46684,6.3
55,Wisconsin,1978,3366333,2252463,66.9,2142577,63.6,109886,4.9
56,Wyoming,1978,304250,210275,69.1,204273,67.1,6002,2.9
1,Alabama,1979,2790583,1661114,59.5,1541233,55.2,119881,7.2
2,Alaska,1979,258167,184638,71.5,167898,65.0,16740,9.1
4,Arizona,1979,1908083,1154948,60.5,1096553,57.5,58395,5.1
5,Arkansas,1979,1646917,975825,59.3,914622,55.5,61203,6.3
6,California,1979,17214167,11288184,65.6,10586188,61.5,701996,6.2
8,Colorado,1979,2069833,1435411,69.3,1368793,66.1,66618,4.6
9,Connecticut,1979,2339167,1563642,66.8,1484171,63.4,79471,5.1
10,Delaware,1979,439167,281813,64.2,262118,59.7,19695,7.0
11,District of Columbia,1979,501833,329359,65.6,306776,61.1,22583,6.9
12,Florida,1979,7279417,4145808,57.0,3897939,53.5,247869,6.0
13,Georgia,1979,3828667,2467346,64.4,2341083,61.1,126263,5.1
15,Hawaii,1979,644250,429077,66.6,404493,62.8,24584,5.7
16,Idaho,1979,647917,428898,66.2,403913,62.3,24985,5.8
17,Illinois,1979,8420333,5462279,64.9,5159018,61.3,303261,5.6
18,Indiana,1979,3977750,2632661,66.2,2463223,61.9,169438,6.4
19,Iowa,1979,2142083,1422486,66.4,1363067,63.6,59419,4.2
20,Kansas,1979,1719250,1161492,67.6,1125486,65.5,36006,3.1
21,Kentucky,1979,2619667,1612872,61.6,1523536,58.2,89336,5.5
22,Louisiana,1979,2905500,1722092,59.3,1607615,55.3,114477,6.6
23,Maine,1979,818417,499121,61.0,466066,56.9,33055,6.6
24,Maryland,1979,3114500,2108571,67.7,1987170,63.8,121401,5.8
25,Massachusetts,1979,4338667,2856579,65.8,2700012,62.2,156567,5.5
26,Michigan,1979,6718333,4322170,64.3,3982939,59.3,339231,7.8
27,Minnesota,1979,2957083,2045186,69.2,1957226,66.2,87960,4.3
28,Mississippi,1979,1748333,1022603,58.5,964059,55.1,58544,5.7
29,Missouri,1979,3620750,2305682,63.7,2195930,60.6,109752,4.8
30,Montana,1979,571917,368994,64.5,349806,61.2,19188,5.2
31,Nebraska,1979,1137750,758381,66.7,736830,64.8,21551,2.8
32,Nevada,1979,567667,402171,70.8,382652,67.4,19519,4.9
33,New Hampshire,1979,667583,454226,68.0,439927,65.9,14299,3.1
34,New Jersey,1979,5553917,3561012,64.1,3316808,59.7,244204,6.9
35,New Mexico,1979,895583,551377,61.6,514623,57.5,36754,6.7
36,New York,1979,13278917,7995630,60.2,7428750,55.9,566880,7.1
37,North Carolina,1979,4197500,2809510,66.9,2673939,63.7,135571,4.8
38,North Dakota,1979,463500,300603,64.9,288126,62.2,12477,4.2
39,Ohio,1979,7948500,5058507,63.6,4761077,59.9,297430,5.9
40,Oklahoma,1979,2162917,1311213,60.6,1270580,58.7,40633,3.1
41,Oregon,1979,1923417,1246661,64.8,1162665,60.4,83996,6.7
42,Pennsylvania,1979,9001833,5375725,59.7,5000786,55.6,374939,7.0
44,Rhode Island,1979,719000,463528,64.5,434157,60.4,29371,6.3
45,South Carolina,1979,2169417,1375201,63.4,1306773,60.2,68428,5.0
46,South Dakota,1979,492917,326963,66.3,315990,64.1,10973,3.4
47,Tennessee,1979,3330417,2036959,61.2,1917893,57.6,119066,5.8
48,Texas,1979,9870750,6491001,65.8,6207341,62.9,283660,4.4
49,Utah,1979,929083,606862,65.3,580223,62.5,26639,4.4
50,Vermont,1979,368667,244152,66.2,231997,62.9,12155,5.0
51,Virginia,1979,3824750,2531430,66.2,2411522,63.1,119908,4.7
53,Washington,1979,2940250,1921362,65.3,1790981,60.9,130381,6.8
54,West Virginia,1979,1430417,755637,52.8,700171,48.9,55466,7.3
55,Wisconsin,1979,3419750,2311082,67.6,2207045,64.5,104037,4.5
56,Wyoming,1979,319667,223199,69.8,217637,68.1,5562,2.5
1,Alabama,1980,2829250,1679723,59.4,1531840,54.1,147883,8.8
2,Alaska,1980,264000,188828,71.5,170894,64.7,17934,9.5
4,Arizona,1980,1991917,1232426,61.9,1150950,57.8,81476,6.6
5,Arkansas,1980,1670167,992324,59.4,917629,54.9,74695,7.5
6,California,1980,17687333,11605157,65.6,10806362,61.1,798795,6.9
8,Colorado,1980,2127833,1497824,70.4,1410447,66.3,87377,5.8
9,Connecticut,1980,2368167,1585339,66.9,1495513,63.2,89826,5.7
10,Delaware,1980,440167,284208,64.6,262919,59.7,21289,7.5
11,District of Columbia,1980,491667,323360,65.8,299357,60.9,24003,7.4
12,Florida,1980,7609583,4301636,56.5,4044296,53.1,257340,6.0
13,Georgia,1980,3920333,2534069,64.6,2374644,60.6,159425,6.3
15,Hawaii,1980,663083,440743,66.5,418984,63.2,21759,4.9
16,Idaho,1980,659500,429395,65.1,396955,60.2,32440,7.6
17,Illinois,1980,8473750,5539806,65.4,5086190,60.0,453616,8.2
18,Indiana,1980,4013083,2624984,65.4,2370833,59.1,254151,9.7
19,Iowa,1980,2151250,1428311,66.4,1344122,62.5,84189,5.9
20,Kansas,1980,1739250,1179558,67.8,1127524,64.8,52034,4.4
21,Kentucky,1980,2649750,1661498,62.7,1528256,57.7,133242,8.0
22,Louisiana,1980,2980667,1776751,59.6,1651578,55.4,125173,7.0
23,Maine,1980,826083,506337,61.3,468653,56.7,37684,7.4
24,Maryland,1980,3145417,2143042,68.1,2001458,63.6,141584,6.6
25,Massachusetts,1980,4374417,2871168,65.6,2705849,61.9,165319,5.8
26,Michigan,1980,6769333,4329519,64.0,3798240,56.1,531279,12.3
27,Minnesota,1980,3008583,2101518,69.9,1980163,65.8,121355,5.8
28,Mississippi,1980,1771000,1050404,59.3,972664,54.9,77740,7.4
29,Missouri,1980,3660917,2332959,63.7,2165751,59.2,167208,7.2
30,Montana,1980,574833,372131,64.7,348596,60.6,23535,6.3
31,Nebraska,1980,1148083,763873,66.5,734867,64.0,29006,3.8
32,Nevada,1980,605167,431408,71.3,404162,66.8,27246,6.3
33,New Hampshire,1980,682833,467391,68.4,446355,65.4,21036,4.5
34,New Jersey,1980,5599167,3586628,64.1,3330524,59.5,256104,7.1
35,New Mexico,1980,921583,563793,61.2,520963,56.5,42830,7.6
36,New York,1980,13312917,7976617,59.9,7384324,55.5,592293,7.4
37,North Carolina,1980,4292917,2855525,66.5,2673169,62.3,182356,6.4
38,North Dakota,1980,467083,303520,65.0,288743,61.8,14777,4.9
39,Ohio,1980,7994000,5070041,63.4,4648849,58.2,421192,8.3
40,Oklahoma,1980,2218583,1368350,61.7,1311880,59.1,56470,4.1
41,Oregon,1980,1973917,1289890,65.3,1181682,59.9,108208,8.4
42,Pennsylvania,1980,9049333,5441173,60.1,4998878,55.2,442295,8.1
44,Rhode Island,1980,719917,470866,65.4,436772,60.7,34094,7.2
45,South Carolina,1980,2221250,1395675,62.8,1301796,58.6,93879,6.7
46,South Dakota,1980,495333,331889,67.0,316282,63.9,15607,4.7
47,Tennessee,1980,3399000,2070888,60.9,1921618,56.5,149270,7.2
48,Texas,1980,10222500,6762471,66.2,6407618,62.7,354853,5.2
49,Utah,1980,961667,632246,65.7,592629,61.6,39617,6.3
50,Vermont,1980,376667,249412,66.2,234664,62.3,14748,5.9
51,Virginia,1980,3888500,2563744,65.9,2433183,62.6,130561,5.1
53,Washington,1980,3056083,1970361,64.5,1814249,59.4,156112,7.9
54,West Virginia,1980,1444250,770365,53.3,692508,47.9,77857,10.1
55,Wisconsin,1980,3474833,2349514,67.6,2177119,62.7,172395,7.3
56,Wyoming,1980,335333,235508,70.2,226513,67.5,8995,3.8
1,Alabama,1981,2864250,1686584,58.9,1505947,52.6,180637,10.7
2,Alaska,1981,273750,198021,72.3,179812,65.7,18209,9.2
4,Arizona,1981,2052500,1271333,61.9,1192666,58.1,78667,6.2
5,Arkansas,1981,1686583,1021664,60.6,933659,55.4,88005,8.6
6,California,1981,18068500,11818415,65.4,10939299,60.5,879116,7.4
8,Colorado,1981,2188500,1541823,70.5,1454591,66.5,87232,5.7
9,Connecticut,1981,2396750,1600049,66.8,1500819,62.6,99230,6.2
10,Delaware,1981,445083,287959,64.7,265540,59.7,22419,7.8
11,District of Columbia,1981,488083,310500,63.6,283539,58.1,26961,8.7
12,Florida,1981,7905583,4534762,57.4,4225220,53.4,309542,6.8
13,Georgia,1981,4010083,2593241,64.7,2425289,60.5,167952,6.5
15,Hawaii,1981,675667,450432,66.7,427201,63.2,23231,5.2
16,Idaho,1981,670250,430885,64.3,398041,59.4,32844,7.6
17,Illinois,1981,8528750,5595838,65.6,5113454,60.0,482384,8.6
18,Indiana,1981,4035000,2621027,65.0,2365811,58.6,255216,9.7
19,Iowa,1981,2160083,1428916,66.2,1335522,61.8,93394,6.5
20,Kansas,1981,1755333,1181689,67.3,1130646,64.4,51043,4.3
21,Kentucky,1981,2674750,1667409,62.3,1523608,57.0,143801,8.6
22,Louisiana,1981,3045333,1846264,60.6,1690543,55.5,155721,8.4
23,Maine,1981,835333,512600,61.4,475441,56.9,37159,7.2
24,Maryland,1981,3194583,2167411,67.8,2013686,63.0,153725,7.1
25,Massachusetts,1981,4417500,2945288,66.7,2756609,62.4,188679,6.4
26,Michigan,1981,6781333,4297544,63.4,3765283,55.5,532261,12.4
27,Minnesota,1981,3045250,2142179,70.3,2018612,66.3,123567,5.8
28,Mississippi,1981,1794583,1054711,58.8,964835,53.8,89876,8.5
29,Missouri,1981,3687250,2324577,63.0,2144992,58.2,179585,7.7
30,Montana,1981,581667,382677,65.8,356847,61.3,25830,6.7
31,Nebraska,1981,1158000,772523,66.7,740704,64.0,31819,4.1
32,Nevada,1981,633417,461648,72.9,427766,67.5,33882,7.3
33,New Hampshire,1981,697167,479184,68.7,454956,65.3,24228,5.1
34,New Jersey,1981,5662250,3611992,63.8,3339638,59.0,272354,7.5
35,New Mexico,1981,944250,578071,61.2,536354,56.8,41717,7.2
36,New York,1981,13390583,8009607,59.8,7402631,55.3,606976,7.6
37,North Carolina,1981,4367500,2901656,66.4,2715573,62.2,186083,6.4
38,North Dakota,1981,473000,309628,65.5,294380,62.2,15248,4.9
39,Ohio,1981,8033667,5114048,63.7,4623199,57.5,490849,9.6
40,Oklahoma,1981,2271750,1430931,63.0,1380025,60.7,50906,3.6
41,Oregon,1981,1998250,1327737,66.4,1198694,60.0,129043,9.7
42,Pennsylvania,1981,9107000,5469725,60.1,5012400,55.0,457325,8.4
44,Rhode Island,1981,726417,476727,65.6,440627,60.7,36100,7.6
45,South Carolina,1981,2266583,1432219,63.2,1314907,58.0,117312,8.2
46,South Dakota,1981,496750,333940,67.2,317740,64.0,16200,4.9
47,Tennessee,1981,3441750,2114787,61.4,1926377,56.0,188410,8.9
48,Texas,1981,10555417,7078693,67.1,6700319,63.5,378374,5.3
49,Utah,1981,989583,649311,65.6,606025,61.2,43286,6.7
50,Vermont,1981,381833,257421,67.4,242372,63.5,15049,5.8
51,Virginia,1981,3958750,2610962,66.0,2455453,62.0,155509,6.0
53,Washington,1981,3121583,2006646,64.3,1819243,58.3,187403,9.3
54,West Virginia,1981,1456000,776443,53.3,693944,47.7,82499,10.6
55,Wisconsin,1981,3512917,2375413,67.6,2189577,62.3,185836,7.8
56,Wyoming,1981,348250,247284,71.0,237060,68.1,10224,4.1
1,Alabama,1982,2889583,1720073,59.5,1479959,51.2,240114,14.0
2,Alaska,1982,292417,213405,73.0,192037,65.7,21368,10.0
4,Arizona,1982,2118000,1344759,63.5,1210605,57.2,134154,10.0
5,Arkansas,1982,1698000,1021146,60.1,924559,54.4,96587,9.5
6,California,1982,18426583,12156189,66.0,10932263,59.3,1223926,10.1
8,Colorado,1982,2255250,1594977,70.7,1473118,65.3,121859,7.6
9,Connecticut,1982,2416583,1611073,66.7,1500673,62.1,110400,6.9
10,Delaware,1982,450750,294074,65.2,269439,59.8,24635,8.4
11,District of Columbia,1982,484583,309748,63.9,277754,57.3,31994,10.3
12,Florida,1982,8156667,4700849,57.6,4301377,52.7,399472,8.5
13,Georgia,1982,4084667,2655367,65.0,2448575,59.9,206792,7.8
15,Hawaii,1982,689917,458046,66.4,430039,62.3,28007,6.1
16,Idaho,1982,679750,444686,65.4,400677,58.9,44009,9.9
17,Illinois,1982,8557500,5614852,65.6,4974453,58.1,640399,11.4
18,Indiana,1982,4047750,2611354,64.5,2298111,56.8,313243,12.0
19,Iowa,1982,2158583,1415639,65.6,1296872,60.1,118767,8.4
20,Kansas,1982,1770917,1193636,67.4,1118398,63.2,75238,6.3
21,Kentucky,1982,2697250,1683779,62.4,1501595,55.7,182184,10.8
22,Louisiana,1982,3108667,1867187,60.1,1676469,53.9,190718,10.2
23,Maine,1982,843167,521424,61.8,476722,56.5,44702,8.6
24,Maryland,1982,3226500,2181679,67.6,2001581,62.0,180098,8.3
25,Massachusetts,1982,4443000,2979497,67.1,2747260,61.8,232237,7.8
26,Michigan,1982,6754167,4274498,63.3,3611639,53.5,662859,15.5
27,Minnesota,1982,3069750,2160876,70.4,1989883,64.8,170993,7.9
28,Mississippi,1982,1814083,1065524,58.7,948489,52.3,117035,11.0
29,Missouri,1982,3702167,2327275,62.9,2111562,57.0,215713,9.3
30,Montana,1982,588250,388163,66.0,354790,60.3,33373,8.6
31,Nebraska,1982,1164250,782098,67.2,739337,63.5,42761,5.5
32,Nevada,1982,657667,482925,73.4,434375,66.0,48550,10.1
33,New Hampshire,1982,709500,487172,68.7,453628,63.9,33544,6.9
34,New Jersey,1982,5714250,3636895,63.6,3319882,58.1,317013,8.7
35,New Mexico,1982,968000,597293,61.7,543522,56.1,53771,9.0
36,New York,1982,13464250,7997094,59.4,7302599,54.2,694495,8.7
37,North Carolina,1982,4435750,2942038,66.3,2669735,60.2,272303,9.3
38,North Dakota,1982,479250,313918,65.5,296392,61.8,17526,5.6
39,Ohio,1982,8045417,5121163,63.7,4477347,55.7,643816,12.6
40,Oklahoma,1982,2350167,1488608,63.3,1398011,59.5,90597,6.1
41,Oregon,1982,2003250,1326493,66.2,1175980,58.7,150513,11.3
42,Pennsylvania,1982,9146000,5483006,59.9,4884993,53.4,598013,10.9
44,Rhode Island,1982,731583,482361,65.9,434207,59.4,48154,10.0
45,South Carolina,1982,2307333,1482373,64.2,1322883,57.3,159490,10.8
46,South Dakota,1982,498667,333741,66.9,315629,63.3,18112,5.4
47,Tennessee,1982,3476417,2133426,61.4,1883673,54.2,249753,11.7
48,Texas,1982,10960167,7361339,67.2,6852398,62.5,508941,6.9
49,Utah,1982,1016667,671482,66.0,617075,60.7,54407,8.1
50,Vermont,1982,386750,262770,67.9,244817,63.3,17953,6.8
51,Virginia,1982,4019500,2668646,66.4,2470570,61.5,198076,7.4
53,Washington,1982,3158000,2024630,64.1,1788779,56.6,235851,11.6
54,West Virginia,1982,1463250,780252,53.3,670683,45.8,109569,14.0
55,Wisconsin,1982,3535500,2418295,68.4,2169284,61.4,249011,10.3
56,Wyoming,1982,358000,253139,70.7,238116,66.5,15023,5.9
1,Alabama,1983,2911083,1756534,60.3,1513847,52.0,242687,13.8
2,Alaska,1983,319833,230474,72.1,207216,64.8,23258,10.1
4,Arizona,1983,2190667,1389857,63.4,1263574,57.7,126283,9.1
5,Arkansas,1983,1716750,1037698,60.4,937019,54.6,100679,9.7
6,California,1983,18725000,12302286,65.7,11094344,59.2,1207942,9.8
8,Colorado,1983,2314917,1660125,71.7,1542722,66.6,117403,7.1
9,Connecticut,1983,2432000,1620319,66.6,1523137,62.6,97182,6.0
10,Delaware,1983,456000,296295,65.0,272913,59.8,23382,7.9
11,District of Columbia,1983,483083,314988,65.2,280656,58.1,34332,10.9
12,Florida,1983,8398083,4899627,58.3,4477870,53.3,421757,8.6
13,Georgia,1983,4149833,2696926,65.0,2491523,60.0,205403,7.6
15,Hawaii,1983,707417,470850,66.6,442989,62.6,27861,5.9
16,Idaho,1983,689750,453929,65.8,412697,59.8,41232,9.1
17,Illinois,1983,8578750,5600205,65.3,4945354,57.6,654851,11.7
18,Indiana,1983,4055750,2590061,63.9,2302886,56.8,287175,11.1
19,Iowa,1983,2159250,1417144,65.6,1300692,60.2,116452,8.2
20,Kansas,1983,1784417,1194270,66.9,1123813,63.0,70457,5.9
21,Kentucky,1983,2720250,1696793,62.4,1505906,55.4,190887,11.2
22,Louisiana,1983,3163167,1910265,60.4,1689628,53.4,220637,11.6
23,Maine,1983,853500,534910,62.7,490541,57.5,44369,8.3
24,Maryland,1983,3248000,2208015,68.0,2054616,63.3,153399,6.9
25,Massachusetts,1983,4472250,2979135,66.6,2772804,62.0,206331,6.9
26,Michigan,1983,6718250,4267681,63.5,3650527,54.3,617154,14.5
27,Minnesota,1983,3085417,2177919,70.6,2005574,65.0,172345,7.9
28,Mississippi,1983,1825750,1071360,58.7,943119,51.7,128241,12.0
29,Missouri,1983,3728167,2359711,63.3,2125008,57.0,234703,9.9
30,Montana,1983,596250,395691,66.4,361054,60.6,34637,8.8
31,Nebraska,1983,1173250,787703,67.1,743737,63.4,43966,5.6
32,Nevada,1983,671333,487731,72.7,439730,65.5,48001,9.8
33,New Hampshire,1983,721000,501143,69.5,473683,65.7,27460,5.5
34,New Jersey,1983,5779000,3695196,63.9,3392740,58.7,302456,8.2
35,New Mexico,1983,992417,613598,61.8,553947,55.8,59651,9.7
36,New York,1983,13547417,8059904,59.5,7344657,54.2,715247,8.9
37,North Carolina,1983,4489750,2955085,65.8,2692189,60.0,262896,8.9
38,North Dakota,1983,486917,318972,65.5,300196,61.7,18776,5.9
39,Ohio,1983,8032750,5110741,63.6,4479711,55.8,631030,12.3
40,Oklahoma,1983,2416333,1531400,63.4,1407490,58.2,123910,8.1
41,Oregon,1983,2007750,1339509,66.7,1194251,59.5,145258,10.8
42,Pennsylvania,1983,9176417,5474633,59.7,4866442,53.0,608191,11.1
44,Rhode Island,1983,735417,480971,65.4,440461,59.9,40510,8.4
45,South Carolina,1983,2341083,1479137,63.2,1333162,56.9,145975,9.9
46,South Dakota,1983,503667,336528,66.8,318987,63.3,17541,5.2
47,Tennessee,1983,3504917,2183143,62.3,1929318,55.0,253825,11.6
48,Texas,1983,11286167,7632139,67.6,7017329,62.2,614810,8.1
49,Utah,1983,1045750,690668,66.0,628395,60.1,62273,9.0
50,Vermont,1983,391667,265881,67.9,248510,63.4,17371,6.5
51,Virginia,1983,4082000,2728372,66.8,2555773,62.6,172599,6.3
53,Washington,1983,3186750,2048647,64.3,1819782,57.1,228865,11.2
54,West Virginia,1983,1470333,762562,51.9,631004,42.9,131558,17.3
55,Wisconsin,1983,3540083,2407826,68.0,2171820,61.3,236006,9.8
56,Wyoming,1983,363083,256895,70.8,236420,65.1,20475,8.0
1,Alabama,1984,2939000,1785713,60.8,1584171,53.9,201542,11.3
2,Alaska,1984,335667,243254,72.5,219239,65.3,24015,9.9
4,Arizona,1984,2268833,1438991,63.4,1367661,60.3,71330,5.0
5,Arkansas,1984,1733750,1048337,60.5,958944,55.3,89393,8.5
6,California,1984,19162167,12611205,65.8,11634051,60.7,977154,7.7
8,Colorado,1984,2354917,1704383,72.4,1610984,68.4,93399,5.5
9,Connecticut,1984,2451083,1669603,68.1,1591817,64.9,77786,4.7
10,Delaware,1984,462917,307879,66.5,288818,62.4,19061,6.2
11,District of Columbia,1984,483000,320359,66.3,292012,60.5,28347,8.8
12,Florida,1984,8654750,5153096,59.5,4813803,55.6,339293,6.6
13,Georgia,1984,4241083,2774347,65.4,2605431,61.4,168916,6.1
15,Hawaii,1984,719500,473967,65.9,448206,62.3,25761,5.4
16,Idaho,1984,699083,462827,66.2,429535,61.4,33292,7.2
17,Illinois,1984,8613583,5610383,65.1,5098532,59.2,511851,9.1
18,Indiana,1984,4076667,2631164,64.5,2408644,59.1,222520,8.5
19,Iowa,1984,2160250,1421296,65.8,1321571,61.2,99725,7.0
20,Kansas,1984,1795333,1204362,67.1,1144575,63.8,59787,5.0
21,Kentucky,1984,2731417,1703374,62.4,1549090,56.7,154284,9.1
22,Louisiana,1984,3184917,1937773,60.8,1740032,54.6,197741,10.2
23,Maine,1984,865250,548322,63.4,514827,59.5,33495,6.1
24,Maryland,1984,3288167,2247452,68.3,2127803,64.7,119649,5.3
25,Massachusetts,1984,4510667,3042527,67.5,2897170,64.2,145357,4.8
26,Michigan,1984,6742500,4311766,63.9,3826961,56.8,484805,11.2
27,Minnesota,1984,3105000,2216438,71.4,2077209,66.9,139229,6.3
28,Mississippi,1984,1840417,1085823,59.0,970617,52.7,115206,10.6
29,Missouri,1984,3756417,2376245,63.3,2200916,58.6,175329,7.4
30,Montana,1984,601417,402950,67.0,372766,62.0,30184,7.5
31,Nebraska,1984,1178667,790704,67.1,755315,64.1,35389,4.5
32,Nevada,1984,691583,500091,72.3,461800,66.8,38291,7.7
33,New Hampshire,1984,737583,522206,70.8,500362,67.8,21844,4.2
34,New Jersey,1984,5834250,3804285,65.2,3566154,61.1,238131,6.3
35,New Mexico,1984,1011417,627672,62.1,579213,57.3,48459,7.7
36,New York,1984,13629000,8101645,59.4,7516040,55.1,585605,7.2
37,North Carolina,1984,4571667,3031815,66.3,2832167,62.0,199648,6.6
38,North Dakota,1984,489250,323885,66.2,306566,62.7,17319,5.3
39,Ohio,1984,8040083,5108972,63.5,4625810,57.5,483162,9.5
40,Oklahoma,1984,2422833,1545960,63.8,1441406,59.5,104554,6.8
41,Oregon,1984,2022833,1334030,65.9,1209783,59.8,124247,9.3
42,Pennsylvania,1984,9195167,5491972,59.7,5001555,54.4,490417,8.9
44,Rhode Island,1984,741667,488313,65.8,462427,62.3,25886,5.3
45,South Carolina,1984,2378500,1495188,62.9,1391286,58.5,103902,6.9
46,South Dakota,1984,507167,340716,67.2,325839,64.2,14877,4.4
47,Tennessee,1984,3542000,2226675,62.9,2030540,57.3,196135,8.8
48,Texas,1984,11528417,7877566,68.3,7393901,64.1,483665,6.1
49,Utah,1984,1050083,708004,67.4,661510,63.0,46494,6.6
50,Vermont,1984,396167,270746,68.3,257479,65.0,13267,4.9
51,Virginia,1984,4152917,2809612,67.7,2667055,64.2,142557,5.1
53,Washington,1984,3226083,2076526,64.4,1883475,58.4,193051,9.3
54,West Virginia,1984,1468083,758186,51.6,651199,44.4,106987,14.1
55,Wisconsin,1984,3555250,2399766,67.5,2225602,62.6,174164,7.3
56,Wyoming,1984,361833,254894,70.4,238808,66.0,16086,6.3
1,Alabama,1985,2969083,1804882,60.8,1632415,55.0,172467,9.6
2,Alaska,1985,343250,249601,72.7,224970,65.5,24631,9.9
4,Arizona,1985,2352667,1490450,63.4,1395353,59.3,95097,6.4
5,Arkansas,1985,1747583,1054661,60.3,965075,55.2,89586,8.5
6,California,1985,19644083,12968975,66.0,12035026,61.3,933949,7.2
8,Colorado,1985,2386000,1710753,71.7,1608458,67.4,102295,6.0
9,Connecticut,1985,2469917,1702636,68.9,1627790,65.9,74846,4.4
10,Delaware,1985,471583,316616,67.1,300321,63.7,16295,5.1
11,District of Columbia,1985,483417,322394,66.7,296654,61.4,25740,8.0
12,Florida,1985,8910917,5339493,59.9,5015083,56.3,324410,6.1
13,Georgia,1985,4359583,2874345,65.9,2691885,61.7,182460,6.3
15,Hawaii,1985,730667,481644,65.9,456507,62.5,25137,5.2
16,Idaho,1985,700333,466831,66.7,430397,61.5,36434,7.8
17,Illinois,1985,8635917,5659777,65.5,5146361,59.6,513416,9.1
18,Indiana,1985,4092250,2701795,66.0,2494020,60.9,207775,7.7
19,Iowa,1985,2149083,1423606,66.2,1318126,61.3,105480,7.4
20,Kansas,1985,1794083,1230529,68.6,1167067,65.1,63462,5.2
21,Kentucky,1985,2745500,1698511,61.9,1545506,56.3,153005,9.0
22,Louisiana,1985,3199250,1970579,61.6,1744815,54.5,225764,11.5
23,Maine,1985,874583,555178,63.5,524201,59.9,30977,5.6
24,Maryland,1985,3339583,2278294,68.2,2172809,65.1,105485,4.6
25,Massachusetts,1985,4533833,3053401,67.3,2927250,64.6,126151,4.1
26,Michigan,1985,6793833,4359727,64.2,3923168,57.7,436559,10.0
27,Minnesota,1985,3122250,2235179,71.6,2100173,67.3,135006,6.0
28,Mississippi,1985,1864583,1122529,60.2,1005323,53.9,117206,10.4
29,Missouri,1985,3777667,2438500,64.6,2276927,60.3,161573,6.6
30,Montana,1985,603250,404277,67.0,373145,61.9,31132,7.7
31,Nebraska,1985,1172750,804954,68.6,764128,65.2,40826,5.1
32,Nevada,1985,721000,516828,71.7,478126,66.3,38702,7.5
33,New Hampshire,1985,757333,539248,71.2,519465,68.6,19783,3.7
34,New Jersey,1985,5869250,3832477,65.3,3617038,61.6,215439,5.6
35,New Mexico,1985,1027667,650229,63.3,594344,57.8,55885,8.6
36,New York,1985,13682667,8298702,60.7,7748628,56.6,550074,6.6
37,North Carolina,1985,4668167,3111146,66.6,2934953,62.9,176193,5.7
38,North Dakota,1985,486583,329378,67.7,311348,64.0,18030,5.5
39,Ohio,1985,8074083,5140859,63.7,4681446,58.0,459413,8.9
40,Oklahoma,1985,2406250,1557552,64.7,1446639,60.1,110913,7.1
41,Oregon,1985,2027250,1327140,65.5,1212361,59.8,114779,8.6
42,Pennsylvania,1985,9203667,5546950,60.3,5102804,55.4,444146,8.0
44,Rhode Island,1985,748000,498716,66.7,475325,63.5,23391,4.7
45,South Carolina,1985,2426500,1548924,63.8,1443612,59.5,105312,6.8
46,South Dakota,1985,506250,346113,68.4,329350,65.1,16763,4.8
47,Tennessee,1985,3595667,2252329,62.6,2073593,57.7,178736,7.9
48,Texas,1985,11752250,8082801,68.8,7514336,63.9,568465,7.0
49,Utah,1985,1062500,733325,69.0,688890,64.8,44435,6.1
50,Vermont,1985,401750,279312,69.5,266490,66.3,12822,4.6
51,Virginia,1985,4214167,2866064,68.0,2710875,64.3,155189,5.4
53,Washington,1985,3258750,2107564,64.7,1933767,59.3,173797,8.2
54,West Virginia,1985,1462917,752488,51.4,653421,44.7,99067,13.2
55,Wisconsin,1985,3572500,2397272,67.1,2225867,62.3,171405,7.2
56,Wyoming,1985,358083,253769,70.9,236011,65.9,17758,7.0
1,Alabama,1986,3001083,1852269,61.7,1675271,55.8,176998,9.6
2,Alaska,1986,349917,254814,72.8,226558,64.7,28256,11.1
4,Arizona,1986,2427250,1569107,64.6,1458776,60.1,110331,7.0
5,Arkansas,1986,1761667,1072750,60.9,981090,55.7,91660,8.5
6,California,1986,20065167,13337468,66.5,12436979,62.0,900489,6.8
8,Colorado,1986,2415667,1705113,70.6,1576895,65.3,128218,7.5
9,Connecticut,1986,2487500,1733909,69.7,1668866,67.1,65043,3.8
10,Delaware,1986,480083,324432,67.6,310861,64.8,13571,4.2
11,District of Columbia,1986,479250,323086,67.4,299294,62.5,23792,7.4
12,Florida,1986,9165917,5579374,60.9,5254017,57.3,325357,5.8
13,Georgia,1986,4449917,2979197,66.9,2803495,63.0,175702,5.9
15,Hawaii,1986,744917,493152,66.2,470179,63.1,22973,4.7
16,Idaho,1986,707083,472247,66.8,432737,61.2,39510,8.4
17,Illinois,1986,8681500,5693266,65.6,5220347,60.1,472919,8.3
18,Indiana,1986,4120000,2740825,66.5,2554884,62.0,185941,6.8
19,Iowa,1986,2139500,1443125,67.5,1345316,62.9,97809,6.8
20,Kansas,1986,1815417,1249332,68.8,1182678,65.1,66654,5.3
21,Kentucky,1986,2760417,1704885,61.8,1547356,56.1,157529,9.2
22,Louisiana,1986,3219417,1973584,61.3,1726659,53.6,246925,12.5
23,Maine,1986,883417,565923,64.1,535955,60.7,29968,5.3
24,Maryland,1986,3391917,2350842,69.3,2244036,66.2,106806,4.5
25,Massachusetts,1986,4562833,3067544,67.2,2945306,64.5,122238,4.0
26,Michigan,1986,6857417,4401700,64.2,4009884,58.5,391816,8.9
27,Minnesota,1986,3162333,2253043,71.2,2127559,67.3,125484,5.6
28,Mississippi,1986,1868583,1150627,61.6,1019567,54.6,131060,11.4
29,Missouri,1986,3821750,2505407,65.6,2345518,61.4,159889,6.4
30,Montana,1986,600333,404222,67.3,372088,62.0,32134,7.9
31,Nebraska,1986,1178500,813639,69.0,774352,65.7,39287,4.8
32,Nevada,1986,736750,532518,72.3,498789,67.7,33729,6.3
33,New Hampshire,1986,779250,559445,71.8,544635,69.9,14810,2.6
34,New Jersey,1986,5947750,3898668,65.5,3702846,62.3,195822,5.0
35,New Mexico,1986,1055833,668735,63.3,607095,57.5,61640,9.2
36,New York,1986,13717250,8426495,61.4,7903976,57.6,522519,6.2
37,North Carolina,1986,4730750,3186254,67.4,3017601,63.8,168653,5.3
38,North Dakota,1986,486500,331531,68.1,313077,64.4,18454,5.6
39,Ohio,1986,8102083,5220947,64.4,4787676,59.1,433271,8.3
40,Oklahoma,1986,2419417,1581144,65.4,1449909,59.9,131235,8.3
41,Oregon,1986,2055500,1363105,66.3,1254853,61.0,108252,7.9
42,Pennsylvania,1986,9243500,5622267,60.8,5229656,56.6,392611,7.0
44,Rhode Island,1986,754250,505908,67.1,485271,64.3,20637,4.1
45,South Carolina,1986,2455333,1592306,64.9,1491069,60.7,101237,6.4
46,South Dakota,1986,511250,350108,68.5,333947,65.3,16161,4.6
47,Tennessee,1986,3628750,2293092,63.2,2111485,58.2,181607,7.9
48,Texas,1986,11939500,8173588,68.5,7456997,62.5,716591,8.8
49,Utah,1986,1076917,751868,69.8,705645,65.5,46223,6.1
50,Vermont,1986,407000,288437,70.9,275951,67.8,12486,4.3
51,Virginia,1986,4299250,2918476,67.9,2773994,64.5,144482,5.0
53,Washington,1986,3328417,2184947,65.6,2007967,60.3,176980,8.1
54,West Virginia,1986,1455667,746870,51.3,656873,45.1,89997,12.0
55,Wisconsin,1986,3591333,2431681,67.7,2267118,63.1,164563,6.8
56,Wyoming,1986,358417,251398,70.1,229768,64.1,21630,8.6
1,Alabama,1987,3035833,1867330,61.5,1714379,56.5,152951,8.2
2,Alaska,1987,345500,249574,72.2,224237,64.9,25337,10.2
4,Arizona,1987,2511000,1612643,64.2,1507545,60.0,105098,6.5
5,Arkansas,1987,1777333,1092648,61.5,1003763,56.5,88885,8.1
6,California,1987,20525167,13740589,66.9,12939298,63.0,801291,5.8
8,Colorado,1987,2436750,1702950,69.9,1574773,64.6,128177,7.5
9,Connecticut,1987,2505500,1747296,69.7,1692307,67.5,54989,3.1
10,Delaware,1987,490333,333239,68.0,323140,65.9,10099,3.0
11,District of Columbia,1987,473917,328486,69.3,307967,65.0,20519,6.2
12,Florida,1987,9426000,5860506,62.2,5543332,58.8,317174,5.4
13,Georgia,1987,4553167,3057532,67.2,2887450,63.4,170082,5.6
15,Hawaii,1987,761917,511531,67.1,492626,64.7,18905,3.7
16,Idaho,1987,711167,472236,66.4,436068,61.3,36168,7.7
17,Illinois,1987,8740917,5764392,65.9,5334172,61.0,430220,7.5
18,Indiana,1987,4158417,2747749,66.1,2579001,62.0,168748,6.1
19,Iowa,1987,2138333,1461652,68.4,1379449,64.5,82203,5.6
20,Kansas,1987,1831583,1264347,69.0,1203518,65.7,60829,4.8
21,Kentucky,1987,2774583,1702424,61.4,1561567,56.3,140857,8.3
22,Louisiana,1987,3196750,1950906,61.0,1720228,53.8,230678,11.8
23,Maine,1987,897917,585565,65.2,559979,62.4,25586,4.4
24,Maryland,1987,3450000,2406952,69.8,2303571,66.8,103381,4.3
25,Massachusetts,1987,4587417,3102943,67.6,2998485,65.4,104458,3.4
26,Michigan,1987,6931333,4506324,65.0,4129103,59.6,377221,8.4
27,Minnesota,1987,3198333,2286883,71.5,2170398,67.9,116485,5.1
28,Mississippi,1987,1877167,1151209,61.3,1035217,55.1,115992,10.1
29,Missouri,1987,3866583,2555877,66.1,2395244,61.9,160633,6.3
30,Montana,1987,597500,401602,67.2,371489,62.2,30113,7.5
31,Nebraska,1987,1182000,812800,68.8,778421,65.9,34379,4.2
32,Nevada,1987,764500,556441,72.8,521886,68.3,34555,6.2
33,New Hampshire,1987,803500,580600,72.3,567665,70.6,12935,2.2
34,New Jersey,1987,6002000,3953640,65.9,3793826,63.2,159814,4.0
35,New Mexico,1987,1072917,676055,63.0,615737,57.4,60318,8.9
36,New York,1987,13765500,8484910,61.6,8076350,58.7,408560,4.8
37,North Carolina,1987,4805583,3272640,68.1,3124223,65.0,148417,4.5
38,North Dakota,1987,483583,330886,68.4,314468,65.0,16418,5.0
39,Ohio,1987,8162917,5265206,64.5,4891781,59.9,373425,7.1
40,Oklahoma,1987,2401333,1551114,64.6,1440122,60.0,110992,7.2
41,Oregon,1987,2084417,1394572,66.9,1308765,62.8,85807,6.2
42,Pennsylvania,1987,9297500,5662387,60.9,5336800,57.4,325587,5.7
44,Rhode Island,1987,762250,514100,67.4,495173,65.0,18927,3.7
45,South Carolina,1987,2495333,1631897,65.4,1542170,61.8,89727,5.5
46,South Dakota,1987,515083,352681,68.5,337480,65.5,15201,4.3
47,Tennessee,1987,3680250,2330559,63.3,2175012,59.1,155547,6.7
48,Texas,1987,12017083,8275026,68.9,7571143,63.0,703883,8.5
49,Utah,1987,1086750,755856,69.6,708535,65.2,47321,6.3
50,Vermont,1987,413250,294972,71.4,283914,68.7,11058,3.7
51,Virginia,1987,4394833,3003631,68.3,2878319,65.5,125312,4.2
53,Washington,1987,3398750,2261466,66.5,2096604,61.7,164862,7.3
54,West Virginia,1987,1449750,741846,51.2,660265,45.5,81581,11.0
55,Wisconsin,1987,3617667,2491219,68.9,2348503,64.9,142716,5.7
56,Wyoming,1987,349500,243015,69.5,223403,63.9,19612,8.1
1,Alabama,1988,3057500,1874512,61.3,1737931,56.8,136581,7.3
2,Alaska,1988,347000,250991,72.3,229051,66.0,21940,8.7
4,Arizona,1988,2572083,1662698,64.6,1556022,60.5,106676,6.4
5,Arkansas,1988,1785000,1107912,62.1,1022652,57.3,85260,7.7
6,California,1988,20983083,14135934,67.4,13390021,63.8,745913,5.3
8,Colorado,1988,2446500,1706310,69.7,1596617,65.3,109693,6.4
9,Connecticut,1988,2516833,1746477,69.4,1696173,67.4,50304,2.9
10,Delaware,1988,500500,347343,69.4,336914,67.3,10429,3.0
11,District of Columbia,1988,465917,328661,70.5,312153,67.0,16508,5.0
12,Florida,1988,9660583,6074954,62.9,5759377,59.6,315577,5.2
13,Georgia,1988,4634833,3147975,67.9,2971341,64.1,176634,5.6
15,Hawaii,1988,776167,518264,66.8,502303,64.7,15961,3.1
16,Idaho,1988,716250,479331,66.9,449810,62.8,29521,6.2
17,Illinois,1988,8790250,5839006,66.4,5445160,61.9,393846,6.7
18,Indiana,1988,4190833,2791749,66.6,2647406,63.2,144343,5.2
19,Iowa,1988,2148583,1489045,69.3,1419797,66.1,69248,4.7
20,Kansas,1988,1845667,1275408,69.1,1218029,66.0,57379,4.5
21,Kentucky,1988,2788667,1714898,61.5,1587089,56.9,127809,7.5
22,Louisiana,1988,3169833,1926370,60.8,1722504,54.3,203866,10.6
23,Maine,1988,914750,598183,65.4,576282,63.0,21901,3.7
24,Maryland,1988,3511167,2458361,70.0,2355321,67.1,103040,4.2
25,Massachusetts,1988,4611500,3153105,68.4,3049072,66.1,104033,3.3
26,Michigan,1988,6967833,4548841,65.3,4204332,60.3,344509,7.6
27,Minnesota,1988,3240500,2312775,71.4,2212985,68.3,99790,4.3
28,Mississippi,1988,1885667,1144961,60.7,1047187,55.5,97774,8.5
29,Missouri,1988,3897000,2590805,66.5,2443392,62.7,147413,5.7
30,Montana,1988,596083,404209,67.8,377497,63.3,26712,6.6
31,Nebraska,1988,1189167,816404,68.7,788223,66.3,28181,3.5
32,Nevada,1988,800000,579856,72.5,549615,68.7,30241,5.2
33,New Hampshire,1988,822583,593492,72.1,579431,70.4,14061,2.4
34,New Jersey,1988,6031333,3971203,65.8,3821755,63.4,149448,3.8
35,New Mexico,1988,1083750,683190,63.0,631398,58.3,51792,7.6
36,New York,1988,13802667,8547450,61.9,8186055,59.3,361395,4.2
37,North Carolina,1988,4875250,3330300,68.3,3206724,65.8,123576,3.7
38,North Dakota,1988,481583,330710,68.7,315500,65.5,15210,4.6
39,Ohio,1988,8230667,5323989,64.7,5003175,60.8,320814,6.0
40,Oklahoma,1988,2385667,1525086,63.9,1428559,59.9,96527,6.3
41,Oregon,1988,2121917,1430996,67.4,1349323,63.6,81673,5.7
42,Pennsylvania,1988,9341750,5759491,61.7,5463388,58.5,296103,5.1
44,Rhode Island,1988,767417,516617,67.3,501398,65.3,15219,2.9
45,South Carolina,1988,2533000,1660533,65.6,1583928,62.5,76605,4.6
46,South Dakota,1988,518417,357032,68.9,342341,66.0,14691,4.1
47,Tennessee,1988,3720667,2333637,62.7,2198415,59.1,135222,5.8
48,Texas,1988,12076500,8350714,69.1,7730608,64.0,620106,7.4
49,Utah,1988,1096750,759366,69.2,721791,65.8,37575,4.9
50,Vermont,1988,422250,299107,70.8,290082,68.7,9025,3.0
51,Virginia,1988,4480667,3083608,68.8,2963334,66.1,120274,3.9
53,Washington,1988,3477250,2334006,67.1,2187896,62.9,146110,6.3
54,West Virginia,1988,1440583,740828,51.4,667193,46.3,73635,9.9
55,Wisconsin,1988,3649000,2549189,69.9,2437606,66.8,111583,4.4
56,Wyoming,1988,345500,239015,69.2,223576,64.7,15439,6.5
1,Alabama,1989,3072833,1899124,61.8,1766197,57.5,132927,7.0
2,Alaska,1989,350000,257917,73.7,239601,68.5,18316,7.1
4,Arizona,1989,2618167,1710093,65.3,1621078,61.9,89015,5.2
5,Arkansas,1989,1790917,1123387,62.7,1044104,58.3,79283,7.1
6,California,1989,21459000,14537086,67.7,13797192,64.3,739894,5.1
8,Colorado,1989,2460417,1711102,69.5,1614923,65.6,96179,5.6
9,Connecticut,1989,2515500,1768762,70.3,1704954,67.8,63808,3.6
10,Delaware,1989,509500,357909,70.2,346129,67.9,11780,3.3
11,District of Columbia,1989,453583,316743,69.8,301494,66.5,15249,4.8
12,Florida,1989,9890833,6259000,63.3,5908010,59.7,350990,5.6
13,Georgia,1989,4699833,3208172,68.3,3035117,64.6,173055,5.4
15,Hawaii,1989,789750,530024,67.1,517005,65.5,13019,2.5
16,Idaho,1989,725667,490404,67.6,463537,63.9,26867,5.5
17,Illinois,1989,8832417,5994480,67.9,5631348,63.8,363132,6.1
18,Indiana,1989,4216333,2850748,67.6,2716337,64.4,134411,4.7
19,Iowa,1989,2154000,1502484,69.8,1437734,66.7,64750,4.3
20,Kansas,1989,1853500,1279617,69.0,1226451,66.2,53166,4.2
21,Kentucky,1989,2796750,1740171,62.2,1629579,58.3,110592,6.4
22,Louisiana,1989,3155667,1887656,59.8,1739003,55.1,148653,7.9
23,Maine,1989,927500,612636,66.1,588218,63.4,24418,4.0
24,Maryland,1989,3556833,2507844,70.5,2413103,67.8,94741,3.8
25,Massachusetts,1989,4617917,3186592,69.0,3052030,66.1,134562,4.2
26,Michigan,1989,6984833,4608840,66.0,4278222,61.3,330618,7.2
27,Minnesota,1989,3268417,2340609,71.6,2238664,68.5,101945,4.4
28,Mississippi,1989,1893583,1163521,61.4,1071801,56.6,91720,7.9
29,Missouri,1989,3910500,2627403,67.2,2482227,63.5,145176,5.5
30,Montana,1989,596333,407527,68.3,383273,64.3,24254,6.0
31,Nebraska,1989,1193750,815765,68.3,792301,66.4,23464,2.9
32,Nevada,1989,840417,602938,71.7,574739,68.4,28199,4.7
33,New Hampshire,1989,837417,607297,72.5,586981,70.1,20316,3.3
34,New Jersey,1989,6032500,3995539,66.2,3833386,63.5,162153,4.1
35,New Mexico,1989,1095500,693917,63.3,647093,59.1,46824,6.7
36,New York,1989,13805167,8679562,62.9,8257658,59.8,421904,4.9
37,North Carolina,1989,4937750,3391363,68.7,3270297,66.2,121066,3.6
38,North Dakota,1989,477417,329439,69.0,315331,66.0,14108,4.3
39,Ohio,1989,8261167,5408179,65.5,5106358,61.8,301821,5.6
40,Oklahoma,1989,2386333,1524504,63.9,1437131,60.2,87373,5.7
41,Oregon,1989,2159750,1468247,68.0,1389582,64.3,78665,5.4
42,Pennsylvania,1989,9366750,5835018,62.3,5549309,59.2,285709,4.9
44,Rhode Island,1989,769667,518819,67.4,498615,64.8,20204,3.9
45,South Carolina,1989,2566000,1693438,66.0,1615009,62.9,78429,4.6
46,South Dakota,1989,519000,360907,69.5,346964,66.9,13943,3.9
47,Tennessee,1989,3752583,2363369,63.0,2242800,59.8,120569,5.1
48,Texas,1989,12216000,8451192,69.2,7883147,64.5,568045,6.7
49,Utah,1989,1109833,786822,70.9,750577,67.6,36245,4.6
50,Vermont,1989,429750,304811,70.9,293748,68.4,11063,3.6
51,Virginia,1989,4545667,3143399,69.2,3021188,66.5,122211,3.9
53,Washington,1989,3554750,2447579,68.9,2302450,64.8,145129,5.9
54,West Virginia,1989,1431417,760691,53.1,694291,48.5,66400,8.7
55,Wisconsin,1989,3669500,2593909,70.7,2482942,67.7,110967,4.3
56,Wyoming,1989,344000,238603,69.4,224022,65.1,14581,6.1
1,Alabama,1990,3072395,1910481,62.2,1780162,57.9,130319,6.8
2,Alaska,1990,371967,270484,72.7,250825,67.4,19659,7.3
4,Arizona,1990,2777098,1785713,64.3,1691996,60.9,93717,5.2
5,Arkansas,1990,1780613,1130225,63.5,1052896,59.1,77329,6.8
6,California,1990,22598254,15141715,67.0,14267872,63.1,873843,5.8
8,Colorado,1990,2488757,1771283,71.2,1680761,67.5,90522,5.1
9,Connecticut,1990,2573504,1817089,70.6,1727249,67.1,89840,4.9
10,Delaware,1990,512095,360126,70.3,344167,67.2,15959,4.4
11,District of Columbia,1990,485446,331677,68.3,312071,64.3,19606,5.9
12,Florida,1990,10261029,6482725,63.2,6078379,59.2,404346,6.2
13,Georgia,1990,4873145,3290128,67.5,3114069,63.9,176059,5.4
15,Hawaii,1990,809147,550484,68.0,536157,66.3,14327,2.6
16,Idaho,1990,728642,494169,67.8,466472,64.0,27697,5.6
17,Illinois,1990,8691495,5928974,68.2,5557044,63.9,371930,6.3
18,Indiana,1990,4182011,2810678,67.2,2668343,63.8,142335,5.1
19,Iowa,1990,2088455,1453820,69.6,1389360,66.5,64460,4.4
20,Kansas,1990,1823499,1272578,69.8,1218561,66.8,54017,4.2
21,Kentucky,1990,2798751,1754564,62.7,1648594,58.9,105970,6.0
22,Louisiana,1990,3072687,1866683,60.8,1750348,57.0,116335,6.2
23,Maine,1990,939446,631993,67.3,598351,63.7,33642,5.3
24,Maryland,1990,3690697,2574511,69.8,2463298,66.7,111213,4.3
25,Massachusetts,1990,4713235,3233071,68.6,3027246,64.2,205825,6.4
26,Michigan,1990,7014564,4614499,65.8,4260960,60.7,353539,7.7
27,Minnesota,1990,3270576,2397175,73.3,2284882,69.9,112293,4.7
28,Mississippi,1990,1894246,1178449,62.2,1089126,57.5,89323,7.6
29,Missouri,1990,3861197,2607053,67.5,2452698,63.5,154355,5.9
30,Montana,1990,595669,403230,67.7,378832,63.6,24398,6.1
31,Nebraska,1990,1162187,824443,70.9,804948,69.3,19495,2.4
32,Nevada,1990,939455,666775,71.0,635524,67.6,31251,4.7
33,New Hampshire,1990,847908,622870,73.5,590148,69.6,32722,5.3
34,New Jersey,1990,6045543,4060426,67.2,3854684,63.8,205742,5.1
35,New Mexico,1990,1118366,711313,63.6,663786,59.4,47527,6.7
36,New York,1990,14078827,8831430,62.7,8361916,59.4,469514,5.3
37,North Carolina,1990,5096212,3478905,68.3,3336193,65.5,142712,4.1
38,North Dakota,1990,463434,316790,68.4,303752,65.5,13038,4.1
39,Ohio,1990,8231273,5407455,65.7,5095359,61.9,312096,5.8
40,Oklahoma,1990,2346785,1520187,64.8,1438152,61.3,82035,5.4
41,Oregon,1990,2193841,1495969,68.2,1415384,64.5,80585,5.4
42,Pennsylvania,1990,9205919,5813610,63.2,5494639,59.7,318971,5.5
44,Rhode Island,1990,775851,523343,67.5,490779,63.3,32564,6.2
45,South Carolina,1990,2611843,1737831,66.5,1652949,63.3,84882,4.9
46,South Dakota,1990,500932,349299,69.7,336623,67.2,12676,3.6
47,Tennessee,1990,3765396,2398216,63.7,2270895,60.3,127321,5.3
48,Texas,1990,12604402,8610301,68.3,8061343,64.0,548958,6.4
49,Utah,1990,1159016,818663,70.6,782889,67.5,35774,4.4
50,Vermont,1990,429402,307008,71.5,292550,68.1,14458,4.7
51,Virginia,1990,4655613,3233668,69.5,3091035,66.4,142633,4.4
53,Washington,1990,3676359,2522048,68.6,2392468,65.1,129580,5.1
54,West Virginia,1990,1398424,769471,55.0,703120,50.3,66351,8.6
55,Wisconsin,1990,3677217,2599064,70.7,2485724,67.6,113340,4.4
56,Wyoming,1990,329521,237162,72.0,225092,68.3,12070,5.1
1,Alabama,1991,3115005,1924056,61.8,1783395,57.3,140661,7.3
2,Alaska,1991,381591,276211,72.4,253192,66.4,23019,8.3
4,Arizona,1991,2854417,1808277,63.4,1702715,59.7,105562,5.8
5,Arkansas,1991,1803118,1136108,63.0,1053080,58.4,83028,7.3
6,California,1991,22780860,15130481,66.4,13949676,61.2,1180805,7.8
8,Colorado,1991,2542584,1802962,70.9,1707570,67.2,95392,5.3
9,Connecticut,1991,2570734,1828627,71.1,1708890,66.5,119737,6.5
10,Delaware,1991,520991,362077,69.5,340715,65.4,21362,5.9
11,District of Columbia,1991,480014,319995,66.7,295423,61.5,24572,7.7
12,Florida,1991,10485655,6510989,62.1,6014172,57.4,496817,7.6
13,Georgia,1991,4976618,3315973,66.6,3140985,63.1,174988,5.3
15,Hawaii,1991,826510,564852,68.3,549066,66.4,15786,2.8
16,Idaho,1991,751752,509647,67.8,477321,63.5,32326,6.3
17,Illinois,1991,8768688,5929544,67.6,5497100,62.7,432444,7.3
18,Indiana,1991,4242413,2800684,66.0,2641117,62.3,159567,5.7
19,Iowa,1991,2104403,1470842,69.9,1401981,66.6,68861,4.7
20,Kansas,1991,1834219,1285549,70.1,1228183,67.0,57366,4.5
21,Kentucky,1991,2827754,1759884,62.2,1631038,57.7,128846,7.3
22,Louisiana,1991,3097061,1904952,61.5,1767256,57.1,137696,7.2
23,Maine,1991,943988,640500,67.9,590703,62.6,49797,7.8
24,Maryland,1991,3719173,2616219,70.3,2460853,66.2,155366,5.9
25,Massachusetts,1991,4695650,3184304,67.8,2902502,61.8,281802,8.8
26,Michigan,1991,7073529,4596908,65.0,4170223,59.0,426685,9.3
27,Minnesota,1991,3308424,2429956,73.4,2305657,69.7,124299,5.1
28,Mississippi,1991,1915135,1183892,61.8,1084601,56.6,99291,8.4
29,Missouri,1991,3892925,2633463,67.6,2460843,63.2,172620,6.6
30,Montana,1991,602293,402858,66.9,374895,62.2,27963,6.9
31,Nebraska,1991,1174176,838758,71.4,816427,69.5,22331,2.7
32,Nevada,1991,998374,700052,70.1,658822,66.0,41230,5.9
33,New Hampshire,1991,848271,619776,73.1,577662,68.1,42114,6.8
34,New Jersey,1991,6075964,4063472,66.9,3787556,62.3,275916,6.8
35,New Mexico,1991,1139093,722652,63.4,670375,58.9,52277,7.2
36,New York,1991,14099913,8745483,62.0,8106964,57.5,638519,7.3
37,North Carolina,1991,5192678,3538567,68.1,3329498,64.1,209069,5.9
38,North Dakota,1991,463999,316428,68.2,302697,65.2,13731,4.3
39,Ohio,1991,8297527,5416042,65.3,5063110,61.0,352932,6.5
40,Oklahoma,1991,2363909,1512513,64.0,1422015,60.2,90498,6.0
41,Oregon,1991,2244004,1515979,67.6,1422487,63.4,93492,6.2
42,Pennsylvania,1991,9257368,5842300,63.1,5438620,58.7,403680,6.9
44,Rhode Island,1991,779699,525354,67.4,481114,61.7,44240,8.4
45,South Carolina,1991,2663759,1767123,66.3,1659196,62.3,107927,6.1
46,South Dakota,1991,505393,354181,70.1,341730,67.6,12451,3.5
47,Tennessee,1991,3822509,2418517,63.3,2258759,59.1,159758,6.6
48,Texas,1991,12807208,8767098,68.5,8157580,63.7,609518,7.0
49,Utah,1991,1202129,847707,70.5,807483,67.2,40224,4.7
50,Vermont,1991,432368,306688,70.9,288513,66.7,18175,5.9
51,Virginia,1991,4714028,3320497,70.4,3128385,66.4,192112,5.8
53,Washington,1991,3762333,2558726,68.0,2402722,63.9,156004,6.1
54,West Virginia,1991,1408715,780574,55.4,697664,49.5,82910,10.6
55,Wisconsin,1991,3720427,2629585,70.7,2487850,66.9,141735,5.4
56,Wyoming,1991,333564,236766,71.0,225041,67.5,11725,5.0
1,Alabama,1992,3151380,1962311,62.3,1814583,57.6,147728,7.5
2,Alaska,1992,394654,286421,72.6,261028,66.1,25393,8.9
4,Arizona,1992,2954322,1875439,63.5,1733258,58.7,142181,7.6
5,Arkansas,1992,1824976,1159463,63.5,1078224,59.1,81239,7.0
6,California,1992,23048542,15303861,66.4,13871386,60.2,1432475,9.4
8,Colorado,1992,2619814,1847634,70.5,1734836,66.2,112798,6.1
9,Connecticut,1992,2558624,1818780,71.1,1685625,65.9,133155,7.3
10,Delaware,1992,528653,366987,69.4,347756,65.8,19231,5.2
11,District of Columbia,1992,473734,317069,66.9,289912,61.2,27157,8.6
12,Florida,1992,10689834,6626483,62.0,6071410,56.8,555073,8.4
13,Georgia,1992,5085498,3421655,67.3,3195577,62.8,226078,6.6
15,Hawaii,1992,840084,576944,68.7,553015,65.8,23929,4.1
16,Idaho,1992,775171,529651,68.3,495136,63.9,34515,6.5
17,Illinois,1992,8844259,6028864,68.2,5555116,62.8,473748,7.9
18,Indiana,1992,4289722,2860440,66.7,2686092,62.6,174348,6.1
19,Iowa,1992,2124507,1525309,71.8,1456943,68.6,68366,4.5
20,Kansas,1992,1857694,1310475,70.5,1250711,67.3,59764,4.6
21,Kentucky,1992,2856435,1777326,62.2,1654836,57.9,122490,6.9
22,Louisiana,1992,3119233,1924722,61.7,1773741,56.9,150981,7.8
23,Maine,1992,945377,641459,67.9,594159,62.8,47300,7.4
24,Maryland,1992,3743319,2655427,70.9,2481615,66.3,173812,6.5
25,Massachusetts,1992,4685947,3184569,68.0,2904566,62.0,280003,8.8
26,Michigan,1992,7128843,4671377,65.5,4247132,59.6,424245,9.1
27,Minnesota,1992,3345228,2464739,73.7,2340499,70.0,124240,5.0
28,Mississippi,1992,1928941,1192623,61.8,1097400,56.9,95223,8.0
29,Missouri,1992,3921321,2642439,67.4,2479416,63.2,163023,6.2
30,Montana,1992,612721,419070,68.4,391005,63.8,28065,6.7
31,Nebraska,1992,1188101,848439,71.4,824364,69.4,24075,2.8
32,Nevada,1992,1046898,728893,69.6,679191,64.9,49702,6.8
33,New Hampshire,1992,850003,618083,72.7,573023,67.4,45060,7.3
34,New Jersey,1992,6097353,4058434,66.6,3713445,60.9,344989,8.5
35,New Mexico,1992,1164473,737279,63.3,683148,58.7,54131,7.3
36,New York,1992,14116134,8751942,62.0,7991253,56.6,760689,8.7
37,North Carolina,1992,5271773,3603488,68.4,3377858,64.1,225630,6.3
38,North Dakota,1992,466195,317227,68.0,302709,64.9,14518,4.6
39,Ohio,1992,8342929,5496129,65.9,5088767,61.0,407362,7.4
40,Oklahoma,1992,2389341,1526575,63.9,1436553,60.1,90022,5.9
41,Oregon,1992,2292833,1558153,68.0,1444655,63.0,113498,7.3
42,Pennsylvania,1992,9284189,5896228,63.5,5456078,58.8,440150,7.5
44,Rhode Island,1992,779475,530333,68.0,482610,61.9,47723,9.0
45,South Carolina,1992,2699745,1799677,66.7,1678803,62.2,120874,6.7
46,South Dakota,1992,511043,360930,70.6,348484,68.2,12446,3.4
47,Tennessee,1992,3875816,2469223,63.7,2309670,59.6,159553,6.5
48,Texas,1992,13035341,9000704,69.0,8308435,63.7,692269,7.7
49,Utah,1992,1250594,882385,70.6,839427,67.1,42958,4.9
50,Vermont,1992,434827,311658,71.7,292223,67.2,19435,6.2
51,Virginia,1992,4780310,3376927,70.6,3168136,66.3,208791,6.2
53,Washington,1992,3857918,2646459,68.6,2456125,63.7,190334,7.2
54,West Virginia,1992,1415983,787489,55.6,699043,49.4,88446,11.2
55,Wisconsin,1992,3766809,2696490,71.6,2559155,67.9,137335,5.1
56,Wyoming,1992,339655,239214,70.4,226241,66.6,12973,5.4
1,Alabama,1993,3194255,1996532,62.5,1852383,58.0,144149,7.2
2,Alaska,1993,403384,294093,72.9,271230,67.2,22863,7.8
4,Arizona,1993,3070311,1941133,63.2,1817831,59.2,123302,6.4
5,Arkansas,1993,1857667,1174395,63.2,1102476,59.3,71919,6.1
6,California,1993,23149223,15262269,65.9,13809100,59.7,1453169,9.5
8,Colorado,1993,2713377,1929295,71.1,1825687,67.3,103608,5.4
9,Connecticut,1993,2552264,1794548,70.3,1678245,65.8,116303,6.5
10,Delaware,1993,537233,375853,70.0,357431,66.5,18422,4.9
11,District of Columbia,1993,470872,314324,66.8,287993,61.2,26331,8.4
12,Florida,1993,10886513,6762182,62.1,6262920,57.5,499262,7.4
13,Georgia,1993,5201462,3501845,67.3,3301631,63.5,200214,5.7
15,Hawaii,1993,850658,582121,68.4,556734,65.4,25387,4.4
16,Idaho,1993,802922,551298,68.7,517797,64.5,33501,6.1
17,Illinois,1993,8928912,6078012,68.1,5623227,63.0,454785,7.5
18,Indiana,1993,4342364,2949646,67.9,2799184,64.5,150462,5.1
19,Iowa,1993,2142778,1555790,72.6,1491661,69.6,64129,4.1
20,Kansas,1993,1879835,1328417,70.7,1262698,67.2,65719,4.9
21,Kentucky,1993,2894782,1800303,62.2,1689090,58.3,111213,6.2
22,Louisiana,1993,3143405,1909259,60.7,1767116,56.2,142143,7.4
23,Maine,1993,948932,630159,66.4,587297,61.9,42862,6.8
24,Maryland,1993,3766632,2661634,70.7,2502493,66.4,159141,6.0
25,Massachusetts,1993,4693661,3187638,67.9,2955441,63.0,232197,7.3
26,Michigan,1993,7175073,4723170,65.8,4376113,61.0,347057,7.3
27,Minnesota,1993,3393198,2514127,74.1,2392688,70.5,121439,4.8
28,Mississippi,1993,1950747,1212765,62.2,1131370,58.0,81395,6.7
29,Missouri,1993,3962466,2686624,67.8,2519588,63.6,167036,6.2
30,Montana,1993,626483,425278,67.9,399352,63.7,25926,6.1
31,Nebraska,1993,1201860,863879,71.9,839870,69.9,24009,2.8
32,Nevada,1993,1095255,767353,70.1,714408,65.2,52945,6.9
33,New Hampshire,1993,857402,620355,72.4,582473,67.9,37882,6.1
34,New Jersey,1993,6128492,4026183,65.7,3713811,60.6,312372,7.8
35,New Mexico,1993,1191937,756564,63.5,701624,58.9,54940,7.3
36,New York,1993,14157688,8732081,61.7,8039606,56.8,692475,7.9
37,North Carolina,1993,5377368,3622825,67.4,3437974,63.9,184851,5.1
38,North Dakota,1993,470059,321732,68.4,308008,65.5,13724,4.3
39,Ohio,1993,8396165,5508854,65.6,5141650,61.2,367204,6.7
40,Oklahoma,1993,2413357,1534491,63.6,1447932,60.0,86559,5.6
41,Oregon,1993,2349663,1602103,68.2,1490337,63.4,111766,7.0
42,Pennsylvania,1993,9322176,5897205,63.3,5489881,58.9,407324,6.9
44,Rhode Island,1993,780168,523220,67.1,483861,62.0,39359,7.5
45,South Carolina,1993,2739480,1826650,66.7,1693483,61.8,133167,7.3
46,South Dakota,1993,519692,367165,70.7,354406,68.2,12759,3.5
47,Tennessee,1993,3936541,2534515,64.4,2386930,60.6,147585,5.8
48,Texas,1993,13293974,9166197,69.0,8505317,64.0,660880,7.2
49,Utah,1993,1303475,936996,71.9,899145,69.0,37851,4.0
50,Vermont,1993,438619,314369,71.7,298015,67.9,16354,5.2
51,Virginia,1993,4853592,3370301,69.4,3195929,65.8,174372,5.2
53,Washington,1993,3954336,2699901,68.3,2503525,63.3,196376,7.3
54,West Virginia,1993,1426084,784095,55.0,703598,49.3,80497,10.3
55,Wisconsin,1993,3817858,2747727,72.0,2628338,68.8,119389,4.3
56,Wyoming,1993,346080,243346,70.3,230438,66.6,12908,5.3
1,Alabama,1994,3228880,2033548,63.0,1907892,59.1,125656,6.2
2,Alaska,1994,409114,300786,73.5,277841,67.9,22945,7.6
4,Arizona,1994,3214383,2105320,65.5,1975000,61.4,130320,6.2
5,Arkansas,1994,1885858,1206333,64.0,1140711,60.5,65622,5.4
6,California,1994,23194655,15266381,65.8,13943532,60.1,1322849,8.7
8,Colorado,1994,2806107,2036075,72.6,1951213,69.5,84862,4.2
9,Connecticut,1994,2548654,1758522,69.0,1660780,65.2,97742,5.6
10,Delaware,1994,545062,384251,70.5,366158,67.2,18093,4.7
11,District of Columbia,1994,464509,309634,66.7,285026,61.4,24608,7.9
12,Florida,1994,11107359,6935038,62.4,6484892,58.4,450146,6.5
13,Georgia,1994,5332009,3606992,67.6,3424282,64.2,182710,5.1
15,Hawaii,1994,859398,583221,67.9,552936,64.3,30285,5.2
16,Idaho,1994,830424,587593,70.8,555266,66.9,32327,5.5
17,Illinois,1994,8989316,6112726,68.0,5756661,64.0,356065,5.8
18,Indiana,1994,4385756,3053341,69.6,2910429,66.4,142912,4.7
19,Iowa,1994,2159048,1575089,73.0,1518146,70.3,56943,3.6
20,Kansas,1994,1899227,1346332,70.9,1281897,67.5,64435,4.8
21,Kentucky,1994,2924296,1828635,62.5,1730427,59.2,98208,5.4
22,Louisiana,1994,3166244,1951910,61.6,1802514,56.9,149396,7.7
23,Maine,1994,951821,627061,65.9,585808,61.5,41253,6.6
24,Maryland,1994,3794945,2689237,70.9,2549050,67.2,140187,5.2
25,Massachusetts,1994,4713875,3196893,67.8,2997235,63.6,199658,6.2
26,Michigan,1994,7225054,4802150,66.5,4509453,62.4,292697,6.1
27,Minnesota,1994,3440836,2580734,75.0,2476739,72.0,103995,4.0
28,Mississippi,1994,1975803,1243756,62.9,1165206,59.0,78550,6.3
29,Missouri,1994,4006945,2740827,68.4,2598977,64.9,141850,5.2
30,Montana,1994,640828,436529,68.1,412510,64.4,24019,5.5
31,Nebraska,1994,1214368,885124,72.9,861870,71.0,23254,2.6
32,Nevada,1994,1158696,811880,70.1,761150,65.7,50730,6.2
33,New Hampshire,1994,866717,626011,72.2,597844,69.0,28167,4.5
34,New Jersey,1994,6158214,4067789,66.1,3790023,61.5,277766,6.8
35,New Mexico,1994,1224400,778886,63.6,727893,59.4,50993,6.5
36,New York,1994,14176908,8687721,61.3,8085906,57.0,601815,6.9
37,North Carolina,1994,5485713,3679610,67.1,3516760,64.1,162850,4.4
38,North Dakota,1994,474256,338299,71.3,325829,68.7,12470,3.7
39,Ohio,1994,8434068,5567716,66.0,5252226,62.3,315490,5.7
40,Oklahoma,1994,2434039,1552390,63.8,1469865,60.4,82525,5.3
41,Oregon,1994,2398575,1641975,68.5,1554657,64.8,87318,5.3
42,Pennsylvania,1994,9351246,5892395,63.0,5518891,59.0,373504,6.3
44,Rhode Island,1994,781777,514760,65.8,480597,61.5,34163,6.6
45,South Carolina,1994,2775049,1841428,66.4,1727714,62.3,113714,6.2
46,South Dakota,1994,529175,376619,71.2,364252,68.8,12367,3.3
47,Tennessee,1994,4003265,2657248,66.4,2529614,63.2,127634,4.8
48,Texas,1994,13557440,9397126,69.3,8779118,64.8,618008,6.6
49,Utah,1994,1357272,995192,73.3,958082,70.6,37110,3.7
50,Vermont,1994,443078,315892,71.3,301923,68.1,13969,4.4
51,Virginia,1994,4918957,3415048,69.4,3250198,66.1,164850,4.8
53,Washington,1994,4036254,2741491,67.9,2568913,63.6,172578,6.3
54,West Virginia,1994,1432102,787408,55.0,717787,50.1,69621,8.8
55,Wisconsin,1994,3860824,2821562,73.1,2702367,70.0,119195,4.2
56,Wyoming,1994,352921,249817,70.8,237595,67.3,12222,4.9
1,Alabama,1995,3253839,2065988,63.5,1944909,59.8,121079,5.9
2,Alaska,1995,415593,302756,72.8,280554,67.5,22202,7.3
4,Arizona,1995,3347789,2236926,66.8,2118341,63.3,118585,5.3
5,Arkansas,1995,1912550,1222813,63.9,1163345,60.8,59468,4.9
6,California,1995,23269337,15272582,65.6,14068313,60.5,1204269,7.9
8,Colorado,1995,2891171,2125533,73.5,2040057,70.6,85476,4.0
9,Connecticut,1995,2550795,1740557,68.2,1648401,64.6,92156,5.3
10,Delaware,1995,555559,385976,69.5,369540,66.5,16436,4.3
11,District of Columbia,1995,457230,300235,65.7,274298,60.0,25937,8.6
12,Florida,1995,11335039,7041153,62.1,6645821,58.6,395332,5.6
13,Georgia,1995,5459973,3689479,67.6,3514203,64.4,175276,4.8
15,Hawaii,1995,867555,585368,67.5,553124,63.8,32244,5.5
16,Idaho,1995,856925,602000,70.3,568898,66.4,33102,5.5
17,Illinois,1995,9040636,6173214,68.3,5851700,64.7,321514,5.2
18,Indiana,1995,4431231,3122864,70.5,2984247,67.3,138617,4.4
19,Iowa,1995,2177652,1588738,73.0,1532912,70.4,55826,3.5
20,Kansas,1995,1920869,1354129,70.5,1295252,67.4,58877,4.3
21,Kentucky,1995,2956394,1856613,62.8,1756619,59.4,99994,5.4
22,Louisiana,1995,3192666,1963728,61.5,1829047,57.3,134681,6.9
23,Maine,1995,955709,639131,66.9,601495,62.9,37636,5.9
24,Maryland,1995,3822757,2712757,71.0,2577825,67.4,134932,5.0
25,Massachusetts,1995,4747090,3203588,67.5,3028707,63.8,174881,5.5
26,Michigan,1995,7287368,4830790,66.3,4573514,62.8,257276,5.3
27,Minnesota,1995,3489057,2626976,75.3,2530355,72.5,96621,3.7
28,Mississippi,1995,2002192,1254599,62.7,1176966,58.8,77633,6.2
29,Missouri,1995,4048757,2839875,70.1,2703585,66.8,136290,4.8
30,Montana,1995,655757,442616,67.5,417361,63.6,25255,5.7
31,Nebraska,1995,1230543,901405,73.3,877863,71.3,23542,2.6
32,Nevada,1995,1222720,848452,69.4,801122,65.5,47330,5.6
33,New Hampshire,1995,879282,632401,71.9,608220,69.2,24181,3.8
34,New Jersey,1995,6196853,4115289,66.4,3851225,62.1,264064,6.4
35,New Mexico,1995,1254280,796740,63.5,743735,59.3,53005,6.7
36,New York,1995,14194879,8668388,61.1,8118546,57.2,549842,6.3
37,North Carolina,1995,5602058,3753054,67.0,3589633,64.1,163421,4.4
38,North Dakota,1995,478537,341334,71.3,330053,69.0,11281,3.3
39,Ohio,1995,8480637,5603018,66.1,5329943,62.8,273075,4.9
40,Oklahoma,1995,2454138,1560406,63.6,1491125,60.8,69281,4.4
41,Oregon,1995,2448071,1663019,67.9,1583822,64.7,79197,4.8
42,Pennsylvania,1995,9378316,5900111,62.9,5553073,59.2,347038,5.9
44,Rhode Island,1995,784053,511821,65.3,479387,61.1,32434,6.3
45,South Carolina,1995,2813952,1864221,66.2,1768540,62.8,95681,5.1
46,South Dakota,1995,537657,384621,71.5,372395,69.3,12226,3.2
47,Tennessee,1995,4075573,2723127,66.8,2582870,63.4,140257,5.2
48,Texas,1995,13815490,9575849,69.3,8989910,65.1,585939,6.1
49,Utah,1995,1406487,1018732,72.4,983632,69.9,35100,3.4
50,Vermont,1995,448121,319872,71.4,306565,68.4,13307,4.2
51,Virginia,1995,4982739,3447155,69.2,3293865,66.1,153290,4.4
53,Washington,1995,4118590,2803674,68.1,2628791,63.8,174883,6.2
54,West Virginia,1995,1434620,786498,54.8,723841,50.5,62657,8.0
55,Wisconsin,1995,3908123,2871308,73.5,2764753,70.7,106555,3.7
56,Wyoming,1995,358595,253214,70.6,241060,67.2,12154,4.8
1,Alabama,1996,3284630,2091357,63.7,1982621,60.4,108736,5.2
2,Alaska,1996,420657,308564,73.4,285659,67.9,22905,7.4
4,Arizona,1996,3465028,2287146,66.0,2161444,62.4,125702,5.5
5,Arkansas,1996,1938824,1237579,63.8,1173516,60.5,64063,5.2
6,California,1996,23453185,15399748,65.7,14268104,60.8,1131644,7.3
8,Colorado,1996,2969567,2157862,72.7,2067922,69.6,89940,4.2
9,Connecticut,1996,2558852,1749240,68.4,1658161,64.8,91079,5.2
10,Delaware,1996,565138,388837,68.8,369489,65.4,19348,5.0
11,District of Columbia,1996,453283,290648,64.1,266160,58.7,24488,8.4
12,Florida,1996,11574135,7179271,62.0,6801020,58.8,378251,5.3
13,Georgia,1996,5591770,3806941,68.1,3631786,64.9,175155,4.6
15,Hawaii,1996,877213,594972,67.8,559622,63.8,35350,5.9
16,Idaho,1996,879010,617087,70.2,583655,66.4,33432,5.4
17,Illinois,1996,9101290,6244016,68.6,5913079,65.0,330937,5.3
18,Indiana,1996,4478040,3099954,69.2,2976644,66.5,123310,4.0
19,Iowa,1996,2192256,1609787,73.4,1551881,70.8,57906,3.6
20,Kansas,1996,1940011,1367812,70.5,1309635,67.5,58177,4.3
21,Kentucky,1996,2986241,1873508,62.7,1771831,59.3,101677,5.4
22,Louisiana,1996,3219755,1989419,61.8,1860721,57.8,128698,6.5
23,Maine,1996,962848,654553,68.0,619707,64.4,34846,5.3
24,Maryland,1996,3859320,2749092,71.2,2613028,67.7,136064,4.9
25,Massachusetts,1996,4781387,3236058,67.7,3086616,64.6,149442,4.6
26,Michigan,1996,7359848,4893169,66.5,4653262,63.2,239907,4.9
27,Minnesota,1996,3540527,2664152,75.2,2562942,72.4,101210,3.8
28,Mississippi,1996,2025415,1263385,62.4,1187620,58.6,75765,6.0
29,Missouri,1996,4091569,2893926,70.7,2757151,67.4,136775,4.7
30,Montana,1996,667269,448336,67.2,423434,63.5,24902,5.6
31,Nebraska,1996,1246385,914511,73.4,889935,71.4,24576,2.7
32,Nevada,1996,1286411,894523,69.5,849225,66.0,45298,5.1
33,New Hampshire,1996,894598,636271,71.1,612396,68.5,23875,3.8
34,New Jersey,1996,6247242,4183875,67.0,3927350,62.9,256525,6.1
35,New Mexico,1996,1281327,813001,63.4,751904,58.7,61097,7.5
36,New York,1996,14236266,8792042,61.8,8243078,57.9,548964,6.2
37,North Carolina,1996,5720236,3880825,67.8,3711509,64.9,169316,4.4
38,North Dakota,1996,483401,347224,71.8,336291,69.6,10933,3.1
39,Ohio,1996,8522956,5661818,66.4,5378614,63.1,283204,5.0
40,Oklahoma,1996,2482070,1586153,63.9,1522453,61.3,63700,4.0
41,Oregon,1996,2500567,1713057,68.5,1617621,64.7,95436,5.6
42,Pennsylvania,1996,9409219,5985348,63.6,5655464,60.1,329884,5.5
44,Rhode Island,1996,789329,518585,65.7,491480,62.3,27105,5.2
45,South Carolina,1996,2851104,1886064,66.2,1779221,62.4,106843,5.7
46,South Dakota,1996,545307,390438,71.6,377606,69.2,12832,3.3
47,Tennessee,1996,4150130,2763249,66.6,2620208,63.1,143041,5.2
48,Texas,1996,14072456,9727837,69.1,9168003,65.1,559834,5.8
49,Utah,1996,1452951,1041955,71.7,1006743,69.3,35212,3.4
50,Vermont,1996,453496,325484,71.8,311503,68.7,13981,4.3
51,Virginia,1996,5052520,3438841,68.1,3289651,65.1,149190,4.3
53,Washington,1996,4193091,2893865,69.0,2722664,64.9,171201,5.9
54,West Virginia,1996,1437388,790966,55.0,730389,50.8,60577,7.7
55,Wisconsin,1996,3954173,2920463,73.9,2815515,71.2,104948,3.6
56,Wyoming,1996,363019,255091,70.3,242327,66.8,12764,5.0
1,Alabama,1997,3310672,2132295,64.4,2027092,61.2,105203,4.9
2,Alaska,1997,423636,312264,73.7,290602,68.6,21662,6.9
4,Arizona,1997,3584266,2304915,64.3,2198045,61.3,106870,4.6
5,Arkansas,1997,1963265,1239502,63.1,1176115,59.9,63387,5.1
6,California,1997,23829617,15806263,66.3,14795185,62.1,1011078,6.4
8,Colorado,1997,3042964,2214834,72.8,2140315,70.3,74519,3.4
9,Connecticut,1997,2566658,1754598,68.4,1672575,65.2,82023,4.7
10,Delaware,1997,573467,389712,68.0,374170,65.2,15542,4.0
11,District of Columbia,1997,450837,287313,63.7,263995,58.6,23318,8.1
12,Florida,1997,11821564,7385282,62.5,7021725,59.4,363557,4.9
13,Georgia,1997,5727317,3944461,68.9,3768421,65.8,176040,4.5
15,Hawaii,1997,888620,601737,67.7,565988,63.7,35749,5.9
16,Idaho,1997,899095,632640,70.4,599702,66.7,32938,5.2
17,Illinois,1997,9161360,6296315,68.7,5994538,65.4,301777,4.8
18,Indiana,1997,4510432,3118016,69.1,3011559,66.8,106457,3.4
19,Iowa,1997,2203777,1600216,72.6,1549881,70.3,50335,3.1
20,Kansas,1997,1956819,1380868,70.6,1328415,67.9,52453,3.8
21,Kentucky,1997,3005922,1910330,63.6,1810893,60.2,99437,5.2
22,Louisiana,1997,3244010,2007671,61.9,1889325,58.2,118346,5.9
23,Maine,1997,970403,658175,67.8,623926,64.3,34249,5.2
24,Maryland,1997,3889216,2771027,71.2,2637899,67.8,133128,4.8
25,Massachusetts,1997,4819768,3305601,68.6,3171544,65.8,134057,4.1
26,Michigan,1997,7402329,4961910,67.0,4749340,64.2,212570,4.3
27,Minnesota,1997,3585081,2686557,74.9,2600133,72.5,86424,3.2
28,Mississippi,1997,2046888,1272835,62.2,1200405,58.6,72430,5.7
29,Missouri,1997,4132214,2930806,70.9,2803232,67.8,127574,4.4
30,Montana,1997,673364,452633,67.2,427819,63.5,24814,5.5
31,Nebraska,1997,1257727,919274,73.1,896972,71.3,22302,2.4
32,Nevada,1997,1354018,945871,69.9,904551,66.8,41320,4.4
33,New Hampshire,1997,908163,652663,71.9,630664,69.4,21999,3.4
34,New Jersey,1997,6301880,4248548,67.4,4022818,63.8,225730,5.3
35,New Mexico,1997,1299541,820665,63.2,767900,59.1,52765,6.4
36,New York,1997,14294487,9026109,63.1,8447934,59.1,578175,6.4
37,North Carolina,1997,5831164,3962734,68.0,3810687,65.4,152047,3.8
38,North Dakota,1997,485764,349015,71.8,338733,69.7,10282,2.9
39,Ohio,1997,8547942,5719007,66.9,5453640,63.8,265367,4.6
40,Oklahoma,1997,2509419,1608679,64.1,1545046,61.6,63633,4.0
41,Oregon,1997,2544480,1745396,68.6,1648734,64.8,96662,5.5
42,Pennsylvania,1997,9420957,6061222,64.3,5749513,61.0,311709,5.1
44,Rhode Island,1997,794188,531429,66.9,503143,63.4,28286,5.3
45,South Carolina,1997,2897839,1920244,66.3,1834337,63.3,85907,4.5
46,South Dakota,1997,548956,393844,71.7,382286,69.6,11558,2.9
47,Tennessee,1997,4218938,2780642,65.9,2634225,62.4,146417,5.3
48,Texas,1997,14351589,9914827,69.1,9379863,65.4,534964,5.4
49,Utah,1997,1491332,1069942,71.7,1036174,69.5,33768,3.2
50,Vermont,1997,458789,330073,71.9,317059,69.1,13014,3.9
51,Virginia,1997,5116552,3464890,67.7,3336527,65.2,128363,3.7
53,Washington,1997,4273176,2969804,69.5,2823819,66.1,145985,4.9
54,West Virginia,1997,1436405,790866,55.1,735590,51.2,55276,7.0
55,Wisconsin,1997,3987222,2955752,74.1,2852665,71.5,103087,3.5
56,Wyoming,1997,365527,256151,70.1,243944,66.7,12207,4.8
1,Alabama,1998,3342047,2142084,64.1,2046338,61.2,95746,4.5
2,Alaska,1998,426700,315314,73.9,295323,69.2,19991,6.3
4,Arizona,1998,3680505,2389188,64.9,2287247,62.1,101941,4.3
5,Arkansas,1998,1981707,1244905,62.8,1181961,59.6,62944,5.1
6,California,1998,24271632,16174071,66.6,15213328,62.7,960743,5.9
8,Colorado,1998,3111611,2304973,74.1,2221432,71.4,83541,3.6
9,Connecticut,1998,2573215,1740279,67.6,1683872,65.4,56407,3.2
10,Delaware,1998,581547,396044,68.1,382131,65.7,13913,3.5
11,District of Columbia,1998,452808,293324,64.8,268937,59.4,24387,8.3
12,Florida,1998,12056827,7549879,62.6,7214413,59.8,335466,4.4
13,Georgia,1998,5852865,4047860,69.2,3878294,66.3,169566,4.2
15,Hawaii,1998,895694,602650,67.3,567545,63.4,35105,5.8
16,Idaho,1998,916680,651254,71.0,617126,67.3,34128,5.2
17,Illinois,1998,9230764,6339411,68.7,6055561,65.6,283850,4.5
18,Indiana,1998,4539240,3121554,68.8,3027701,66.7,93853,3.0
19,Iowa,1998,2213630,1594041,72.0,1548820,70.0,45221,2.8
20,Kansas,1998,1974711,1399168,70.9,1347503,68.2,51665,3.7
21,Kentucky,1998,3034769,1923021,63.4,1836351,60.5,86670,4.5
22,Louisiana,1998,3262933,2029167,62.2,1916965,58.7,112202,5.5
23,Maine,1998,975875,655518,67.2,626124,64.2,29394,4.5
24,Maryland,1998,3919446,2763123,70.5,2645646,67.5,117477,4.3
25,Massachusetts,1998,4854899,3331560,68.6,3218908,66.3,112652,3.4
26,Michigan,1998,7433309,5019951,67.5,4820431,64.8,199520,4.0
27,Minnesota,1998,3626469,2716371,74.9,2643596,72.9,72775,2.7
28,Mississippi,1998,2067694,1276022,61.7,1208993,58.5,67029,5.3
29,Missouri,1998,4165026,2946188,70.7,2827027,67.9,119161,4.0
30,Montana,1998,676543,462542,68.4,436497,64.5,26045,5.6
31,Nebraska,1998,1266318,926389,73.2,903089,71.3,23300,2.5
32,Nevada,1998,1413959,978130,69.2,937223,66.3,40907,4.2
33,New Hampshire,1998,920645,661845,71.9,643128,69.9,18717,2.8
34,New Jersey,1998,6352436,4234802,66.7,4040639,63.6,194163,4.6
35,New Mexico,1998,1316837,834613,63.4,782512,59.4,52101,6.2
36,New York,1998,14384124,9074633,63.1,8566015,59.6,508618,5.6
37,North Carolina,1998,5941176,3972102,66.9,3831500,64.5,140602,3.5
38,North Dakota,1998,486378,347088,71.4,336822,69.3,10266,3.0
39,Ohio,1998,8573928,5714432,66.6,5465939,63.8,248493,4.3
40,Oklahoma,1998,2535351,1634852,64.5,1568139,61.9,66713,4.1
41,Oregon,1998,2581476,1777608,68.9,1677094,65.0,100514,5.7
42,Pennsylvania,1998,9439610,6064102,64.2,5779951,61.2,284151,4.7
44,Rhode Island,1998,800630,532183,66.5,507973,63.4,24210,4.5
45,South Carolina,1998,2945825,1940846,65.9,1870270,63.5,70576,3.6
46,South Dakota,1998,551772,398001,72.1,386618,70.1,11383,2.9
47,Tennessee,1998,4272662,2810087,65.8,2688519,62.9,121568,4.3
48,Texas,1998,14638305,10115973,69.1,9613697,65.7,502276,5.0
49,Utah,1998,1524880,1103543,72.4,1064134,69.8,39409,3.6
50,Vermont,1998,463498,334359,72.1,322792,69.6,11567,3.5
51,Virginia,1998,5171501,3499842,67.7,3402386,65.8,97456,2.8
53,Washington,1998,4348345,3031932,69.7,2885396,66.4,146536,4.8
54,West Virginia,1998,1434423,795033,55.4,741971,51.7,53062,6.7
55,Wisconsin,1998,4014688,2965939,73.9,2868464,71.4,97475,3.3
56,Wyoming,1998,366952,260273,70.9,247839,67.5,12434,4.8
1,Alabama,1999,3361672,2149868,64.0,2048492,60.9,101376,4.7
2,Alaska,1999,432679,318295,73.6,297873,68.8,20422,6.4
4,Arizona,1999,3767577,2482545,65.9,2371566,62.9,110979,4.5
5,Arkansas,1999,2004231,1256804,62.7,1199971,59.9,56833,4.5
6,California,1999,24710730,16444135,66.5,15576819,63.0,867316,5.3
8,Colorado,1999,3191591,2337540,73.2,2266969,71.0,70571,3.0
9,Connecticut,1999,2582772,1744020,67.5,1701159,65.9,42861,2.5
10,Delaware,1999,589543,400120,67.9,387005,65.6,13115,3.3
11,District of Columbia,1999,456862,305391,66.8,285335,62.5,20056,6.6
12,Florida,1999,12281589,7702482,62.7,7399031,60.2,303451,3.9
13,Georgia,1999,5974745,4129058,69.1,3971637,66.5,157421,3.8
15,Hawaii,1999,899768,603670,67.1,572297,63.6,31373,5.2
16,Idaho,1999,933848,653982,70.0,621232,66.5,32750,5.0
17,Illinois,1999,9298418,6463079,69.5,6178482,66.4,284597,4.4
18,Indiana,1999,4569132,3121742,68.3,3029823,66.3,91919,2.9
19,Iowa,1999,2224318,1593440,71.6,1550993,69.7,42447,2.7
20,Kansas,1999,1989686,1406631,70.7,1357493,68.2,49138,3.5
21,Kentucky,1999,3062200,1947152,63.6,1859690,60.7,87462,4.5
22,Louisiana,1999,3280605,2025623,61.7,1925041,58.7,100582,5.0
23,Maine,1999,984264,668939,68.0,642081,65.2,26858,4.0
24,Maryland,1999,3954592,2770084,70.0,2674306,67.6,95778,3.5
25,Massachusetts,1999,4894363,3358739,68.6,3247960,66.4,110779,3.3
26,Michigan,1999,7471040,5102445,68.3,4910684,65.7,191761,3.8
27,Minnesota,1999,3678689,2746980,74.7,2672723,72.7,74257,2.7
28,Mississippi,1999,2084667,1283790,61.6,1218258,58.4,65532,5.1
29,Missouri,1999,4201421,2946949,70.1,2852074,67.9,94875,3.2
30,Montana,1999,680888,466729,68.5,441984,64.9,24745,5.3
31,Nebraska,1999,1275410,930022,72.9,904795,70.9,25227,2.7
32,Nevada,1999,1469316,1023530,69.7,982876,66.9,40654,4.0
33,New Hampshire,1999,935044,675423,72.2,656886,70.3,18537,2.7
34,New Jersey,1999,6398991,4283139,66.9,4094543,64.0,188596,4.4
35,New Mexico,1999,1330634,836491,62.9,789414,59.3,47077,5.6
36,New York,1999,14473178,9115114,63.0,8642778,59.7,472336,5.2
37,North Carolina,1999,6040021,4046225,67.0,3912963,64.8,133262,3.3
38,North Dakota,1999,485659,342722,70.6,331927,68.3,10795,3.1
39,Ohio,1999,8596747,5757603,67.0,5508721,64.1,248882,4.3
40,Oklahoma,1999,2561616,1655671,64.6,1597948,62.4,57723,3.5
41,Oregon,1999,2613722,1787762,68.4,1689752,64.6,98010,5.5
42,Pennsylvania,1999,9466514,6093277,64.4,5820571,61.5,272706,4.5
44,Rhode Island,1999,806406,539926,67.0,517211,64.1,22715,4.2
45,South Carolina,1999,2989560,1958598,65.5,1877345,62.8,81253,4.1
46,South Dakota,1999,556421,403381,72.5,392449,70.5,10932,2.7
47,Tennessee,1999,4317553,2842999,65.8,2730146,63.2,112853,4.0
48,Texas,1999,14925355,10266174,68.8,9782226,65.5,483948,4.7
49,Utah,1999,1554094,1123871,72.3,1084452,69.8,39419,3.5
50,Vermont,1999,468457,337468,72.0,327099,69.8,10369,3.1
51,Virginia,1999,5240616,3555130,67.8,3459203,66.0,95927,2.7
53,Washington,1999,4409013,3062751,69.5,2915510,66.1,147241,4.8
54,West Virginia,1999,1432275,799252,55.8,747578,52.2,51674,6.5
55,Wisconsin,1999,4047570,2958137,73.1,2867200,70.8,90937,3.1
56,Wyoming,1999,369959,263801,71.3,251344,67.9,12457,4.7
1,Alabama,2000,3378393,2147173,63.6,2047731,60.6,99442,4.6
2,Alaska,2000,436112,319777,73.3,299590,68.7,20187,6.3
4,Arizona,2000,3849206,2510611,65.2,2410825,62.6,99786,4.0
5,Arkansas,2000,2026044,1260507,62.2,1207833,59.6,52674,4.2
6,California,2000,25116226,16837536,67.0,16011619,63.8,825917,4.9
8,Colorado,2000,3264672,2358371,72.2,2294104,70.3,64267,2.7
9,Connecticut,2000,2594807,1760697,67.9,1723597,66.4,37100,2.1
10,Delaware,2000,597082,412956,69.2,398188,66.7,14768,3.6
11,District of Columbia,2000,458027,309977,67.7,292299,63.8,17678,5.7
12,Florida,2000,12489280,7917857,63.4,7620683,61.0,297174,3.8
13,Georgia,2000,6094409,4202695,69.0,4055366,66.5,147329,3.5
15,Hawaii,2000,900554,605395,67.2,579736,64.4,25659,4.2
16,Idaho,2000,951079,661066,69.5,630228,66.3,30838,4.7
17,Illinois,2000,9346902,6494429,69.5,6206060,66.4,288369,4.4
18,Indiana,2000,4600535,3125304,67.9,3030889,65.9,94415,3.0
19,Iowa,2000,2233091,1594400,71.4,1551434,69.5,42966,2.7
20,Kansas,2000,2001406,1402606,70.1,1349841,67.4,52765,3.8
21,Kentucky,2000,3086153,1957400,63.4,1876232,60.8,81168,4.1
22,Louisiana,2000,3289644,2026392,61.6,1921984,58.4,104408,5.2
23,Maine,2000,994236,677489,68.1,654981,65.9,22508,3.3
24,Maryland,2000,3994408,2801391,70.1,2702430,67.7,98961,3.5
25,Massachusetts,2000,4928941,3340566,67.8,3246356,65.9,94210,2.8
26,Michigan,2000,7516639,5156695,68.6,4968878,66.1,187817,3.6
27,Minnesota,2000,3730567,2799111,75.0,2714001,72.8,85110,3.0
28,Mississippi,2000,2096381,1309882,62.5,1239841,59.1,70041,5.3
29,Missouri,2000,4235660,2971441,70.2,2870458,67.8,100983,3.4
30,Montana,2000,686936,470069,68.4,447383,65.1,22686,4.8
31,Nebraska,2000,1283772,938849,73.1,912620,71.1,26229,2.8
32,Nevada,2000,1522648,1070776,70.3,1026650,67.4,44126,4.1
33,New Hampshire,2000,949844,685799,72.2,667603,70.3,18196,2.7
34,New Jersey,2000,6440442,4287640,66.6,4130824,64.1,156816,3.7
35,New Mexico,2000,1342045,846150,63.0,803666,59.9,42484,5.0
36,New York,2000,14547332,9140541,62.8,8727537,60.0,413004,4.5
37,North Carolina,2000,6114876,4127465,67.5,3972811,65.0,154654,3.7
38,North Dakota,2000,485026,342761,70.7,332615,68.6,10146,3.0
39,Ohio,2000,8623110,5781442,67.0,5544340,64.3,237102,4.1
40,Oklahoma,2000,2579973,1655517,64.2,1605949,62.2,49568,3.0
41,Oregon,2000,2642542,1811837,68.6,1717623,65.0,94214,5.2
42,Pennsylvania,2000,9486292,6105742,64.4,5848152,61.6,257590,4.2
44,Rhode Island,2000,812627,542514,66.8,520813,64.1,21701,4.0
45,South Carolina,2000,3027367,1965481,64.9,1892559,62.5,72922,3.7
46,South Dakota,2000,561564,408496,72.7,398124,70.9,10372,2.5
47,Tennessee,2000,4358399,2849026,65.4,2738785,62.8,110241,3.9
48,Texas,2000,15200557,10388337,68.3,9932973,65.3,455364,4.4
49,Utah,2000,1583059,1142860,72.2,1104750,69.8,38110,3.3
50,Vermont,2000,473915,334055,70.5,324667,68.5,9388,2.8
51,Virginia,2000,5304549,3606390,68.0,3524481,66.4,81909,2.3
53,Washington,2000,4465692,3087680,69.1,2929824,65.6,157856,5.1
54,West Virginia,2000,1430170,799081,55.9,754457,52.8,44624,5.6
55,Wisconsin,2000,4086373,2985643,73.1,2884737,70.6,100906,3.4
56,Wyoming,2000,372818,265701,71.3,255726,68.6,9975,3.8
1,Alabama,2001,3392313,2128027,62.7,2017467,59.5,110560,5.2
2,Alaska,2001,443270,321652,72.6,301422,68.0,20230,6.3
4,Arizona,2001,3953194,2593664,65.6,2470816,62.5,122848,4.7
5,Arkansas,2001,2039774,1261419,61.8,1201314,58.9,60105,4.8
6,California,2001,25526368,17096428,67.0,16160509,63.3,935919,5.5
8,Colorado,2001,3345497,2396012,71.6,2304547,68.9,91465,3.8
9,Connecticut,2001,2611577,1749195,67.0,1698594,65.0,50601,2.9
10,Delaware,2001,604807,421563,69.7,406517,67.2,15046,3.6
11,District of Columbia,2001,460926,311232,67.5,291080,63.2,20152,6.5
12,Florida,2001,12730444,8048882,63.2,7692124,60.4,356758,4.4
13,Georgia,2001,6226566,4257901,68.4,4083528,65.6,174373,4.1
15,Hawaii,2001,907051,607556,67.0,581379,64.1,26177,4.3
16,Idaho,2001,969340,678281,70.0,643913,66.4,34368,5.1
17,Illinois,2001,9408241,6454092,68.6,6103092,64.9,351000,5.4
18,Indiana,2001,4630123,3143985,67.9,3010490,65.0,133495,4.2
19,Iowa,2001,2240136,1610634,71.9,1556923,69.5,53711,3.3
20,Kansas,2001,2014243,1398521,69.4,1338775,66.5,59746,4.3
21,Kentucky,2001,3106382,1953834,62.9,1852043,59.6,101791,5.2
22,Louisiana,2001,3296432,2027220,61.5,1913555,58.0,113665,5.6
23,Maine,2001,1004670,674958,67.2,649627,64.7,25331,3.8
24,Maryland,2001,4049596,2836279,70.0,2717443,67.1,118836,4.2
25,Massachusetts,2001,4972559,3386892,68.1,3258352,65.5,128540,3.8
26,Michigan,2001,7573057,5138844,67.9,4872118,64.3,266726,5.2
27,Minnesota,2001,3780198,2847955,75.3,2740867,72.5,107088,3.8
28,Mississippi,2001,2104190,1294733,61.5,1223536,58.1,71197,5.5
29,Missouri,2001,4272691,2987905,69.9,2853157,66.8,134748,4.5
30,Montana,2001,693174,465355,67.1,443866,64.0,21489,4.6
31,Nebraska,2001,1290958,945374,73.2,915662,70.9,29712,3.1
32,Nevada,2001,1579709,1113529,70.5,1055769,66.8,57760,5.2
33,New Hampshire,2001,965420,692029,71.7,668566,69.3,23463,3.4
34,New Jersey,2001,6488919,4294366,66.2,4112095,63.4,182271,4.2
35,New Mexico,2001,1353307,855088,63.2,812557,60.0,42531,5.0
36,New York,2001,14642218,9126538,62.3,8680547,59.3,445991,4.9
37,North Carolina,2001,6202734,4191959,67.6,3956124,63.8,235835,5.6
38,North Dakota,2001,484467,342528,70.7,332805,68.7,9723,2.8
39,Ohio,2001,8667199,5821151,67.2,5566414,64.2,254737,4.4
40,Oklahoma,2001,2593587,1672620,64.5,1611746,62.1,60874,3.6
41,Oregon,2001,2679820,1815076,67.7,1699359,63.4,115717,6.4
42,Pennsylvania,2001,9515842,6178900,64.9,5882813,61.8,296087,4.8
44,Rhode Island,2001,819602,541661,66.1,517532,63.1,24129,4.5
45,South Carolina,2001,3064191,1941956,63.4,1839246,60.0,102710,5.3
46,South Dakota,2001,566359,413493,73.0,401072,70.8,12421,3.0
47,Tennessee,2001,4401204,2857659,64.9,2728621,62.0,129038,4.5
48,Texas,2001,15494857,10539140,68.0,10014830,64.6,524310,5.0
49,Utah,2001,1620083,1162874,71.8,1112047,68.6,50827,4.4
50,Vermont,2001,478732,338145,70.6,326980,68.3,11165,3.3
51,Virginia,2001,5379278,3681107,68.4,3559669,66.2,121438,3.3
53,Washington,2001,4534286,3085655,68.1,2900354,64.0,185301,6.0
54,West Virginia,2001,1426973,796596,55.8,753657,52.8,42939,5.4
55,Wisconsin,2001,4127721,3017681,73.1,2884305,69.9,133376,4.4
56,Wyoming,2001,375043,268393,71.6,258172,68.8,10221,3.8
1,Alabama,2002,3404450,2112621,62.1,1987633,58.4,124988,5.9
2,Alaska,2002,452064,327054,72.3,303560,67.1,23494,7.2
4,Arizona,2002,4064603,2683502,66.0,2518051,62.0,165451,6.2
5,Arkansas,2002,2053079,1276964,62.2,1209006,58.9,67958,5.3
6,California,2002,25882406,17246528,66.6,16081472,62.1,1165056,6.8
8,Colorado,2002,3405964,2448903,71.9,2309639,67.8,139264,5.7
9,Connecticut,2002,2632063,1776064,67.5,1697788,64.5,78276,4.4
10,Delaware,2002,613177,417207,68.0,399417,65.1,17790,4.3
11,District of Columbia,2002,461676,308760,66.9,287196,62.2,21564,7.0
12,Florida,2002,12994202,8050051,62.0,7651923,58.9,398128,4.9
13,Georgia,2002,6350716,4341617,68.4,4111627,64.7,229990,5.3
15,Hawaii,2002,914847,601786,65.8,577616,63.1,24170,4.0
16,Idaho,2002,988250,685650,69.4,647019,65.5,38631,5.6
17,Illinois,2002,9465460,6341891,67.0,5925990,62.6,415901,6.6
18,Indiana,2002,4657190,3161709,67.9,2997963,64.4,163746,5.2
19,Iowa,2002,2246553,1629047,72.5,1564178,69.6,64869,4.0
20,Kansas,2002,2028297,1419335,70.0,1347163,66.4,72172,5.1
21,Kentucky,2002,3129417,1944682,62.1,1832250,58.5,112432,5.8
22,Louisiana,2002,3309707,2013652,60.8,1892947,57.2,120705,6.0
23,Maine,2002,1015879,678559,66.8,648301,63.8,30258,4.5
24,Maryland,2002,4106699,2872367,69.9,2734977,66.6,137390,4.8
25,Massachusetts,2002,5006050,3436864,68.7,3257517,65.1,179347,5.2
26,Michigan,2002,7621515,5034722,66.1,4723286,62.0,311436,6.2
27,Minnesota,2002,3823098,2873004,75.1,2744745,71.8,128259,4.5
28,Mississippi,2002,2111954,1290793,61.1,1207799,57.2,82994,6.4
29,Missouri,2002,4310430,2981097,69.2,2823361,65.5,157736,5.3
30,Montana,2002,700096,466408,66.6,445122,63.6,21286,4.6
31,Nebraska,2002,1298974,952937,73.4,917833,70.7,35104,3.7
32,Nevada,2002,1634790,1134096,69.4,1069601,65.4,64495,5.7
33,New Hampshire,2002,980304,700563,71.5,668980,68.2,31583,4.5
34,New Jersey,2002,6535944,4345273,66.5,4094389,62.6,250884,5.8
35,New Mexico,2002,1372721,866850,63.1,819275,59.7,47575,5.5
36,New York,2002,14735313,9294770,63.1,8718237,59.2,576533,6.2
37,North Carolina,2002,6286161,4209274,67.0,3917218,62.3,292056,6.9
38,North Dakota,2002,484701,342463,70.7,330852,68.3,11611,3.4
39,Ohio,2002,8709513,5827493,66.9,5490092,63.0,337401,5.8
40,Oklahoma,2002,2611230,1685334,64.5,1607453,61.6,77881,4.6
41,Oregon,2002,2720797,1834254,67.4,1696894,62.4,137360,7.5
42,Pennsylvania,2002,9559024,6214539,65.0,5869299,61.4,345240,5.6
44,Rhode Island,2002,827928,550244,66.5,522201,63.1,28043,5.1
45,South Carolina,2002,3098739,1954548,63.1,1828735,59.0,125813,6.4
46,South Dakota,2002,571138,416793,73.0,403343,70.6,13450,3.2
47,Tennessee,2002,4444871,2898948,65.2,2750424,61.9,148524,5.1
48,Texas,2002,15780780,10742014,68.1,10061049,63.8,680965,6.3
49,Utah,2002,1655613,1179433,71.2,1112581,67.2,66852,5.7
50,Vermont,2002,483460,343261,71.0,330080,68.3,13181,3.8
51,Virginia,2002,5453731,3739499,68.6,3576530,65.6,162969,4.4
53,Washington,2002,4601381,3101001,67.4,2881326,62.6,219675,7.1
54,West Virginia,2002,1428455,798709,55.9,747040,52.3,51669,6.5
55,Wisconsin,2002,4170446,3016760,72.3,2856234,68.5,160526,5.3
56,Wyoming,2002,379314,269405,71.0,258571,68.2,10834,4.0
1,Alabama,2003,3421469,2128668,62.2,2001568,58.5,127100,6.0
2,Alaska,2003,459947,332494,72.3,306964,66.7,25530,7.7
4,Arizona,2003,4174320,2728649,65.4,2571097,61.6,157552,5.8
5,Arkansas,2003,2068570,1282578,62.0,1208583,58.4,73995,5.8
6,California,2003,26210571,17271899,65.9,16081515,61.4,1190384,6.9
8,Colorado,2003,3451821,2490397,72.1,2338432,67.7,151965,6.1
9,Connecticut,2003,2651472,1785737,67.3,1688380,63.7,97357,5.5
10,Delaware,2003,622359,415890,66.8,397310,63.8,18580,4.5
11,District of Columbia,2003,461085,308454,66.9,285997,62.0,22457,7.3
12,Florida,2003,13247147,8123135,61.3,7760904,58.6,362231,4.5
13,Georgia,2003,6465778,4414282,68.3,4187003,64.8,227279,5.1
15,Hawaii,2003,922736,603936,65.5,580352,62.9,23584,3.9
16,Idaho,2003,1006838,691702,68.7,653299,64.9,38403,5.6
17,Illinois,2003,9515975,6310520,66.3,5885134,61.8,425386,6.7
18,Indiana,2003,4687701,3178568,67.8,3011507,64.2,167061,5.3
19,Iowa,2003,2253298,1607931,71.4,1536505,68.2,71426,4.4
20,Kansas,2003,2041137,1441065,70.6,1361115,66.7,79950,5.5
21,Kentucky,2003,3156144,1965881,62.3,1844378,58.4,121503,6.2
22,Louisiana,2003,3326118,2024914,60.9,1897902,57.1,127012,6.3
23,Maine,2003,1026711,685165,66.7,649899,63.3,35266,5.1
24,Maryland,2003,4156957,2881024,69.3,2742966,66.0,138058,4.8
25,Massachusetts,2003,5028614,3418989,68.0,3223294,64.1,195695,5.7
26,Michigan,2003,7667604,5036119,65.7,4678901,61.0,357218,7.1
27,Minnesota,2003,3859916,2893369,75.0,2754850,71.4,138519,4.8
28,Mississippi,2003,2120642,1304578,61.5,1224551,57.7,80027,6.1
29,Missouri,2003,4346056,2983337,68.6,2814661,64.8,168676,5.7
30,Montana,2003,708358,470502,66.4,448251,63.3,22251,4.7
31,Nebraska,2003,1307147,967039,74.0,928916,71.1,38123,3.9
32,Nevada,2003,1690420,1150376,68.1,1089893,64.5,60483,5.3
33,New Hampshire,2003,993695,708938,71.3,677387,68.2,31551,4.5
34,New Jersey,2003,6573502,4344387,66.1,4091465,62.2,252922,5.8
35,New Mexico,2003,1392399,880251,63.2,828390,59.5,51861,5.9
36,New York,2003,14828504,9283810,62.6,8689954,58.6,593856,6.4
37,North Carolina,2003,6363376,4285401,67.3,3997950,62.8,287451,6.7
38,North Dakota,2003,485632,347099,71.5,335092,69.0,12007,3.5
39,Ohio,2003,8751391,5862996,67.0,5498959,62.8,364037,6.2
40,Oklahoma,2003,2626130,1686378,64.2,1595412,60.8,90966,5.4
41,Oregon,2003,2754793,1846328,67.0,1698482,61.7,147846,8.0
42,Pennsylvania,2003,9606890,6157935,64.1,5808102,60.5,349833,5.7
44,Rhode Island,2003,834525,560785,67.2,529583,63.5,31202,5.6
45,South Carolina,2003,3133915,1999485,63.8,1855599,59.2,143886,7.2
46,South Dakota,2003,576254,421524,73.1,406897,70.6,14627,3.5
47,Tennessee,2003,4492255,2904566,64.7,2744351,61.1,160215,5.5
48,Texas,2003,16050108,10910636,68.0,10176554,63.4,734082,6.7
49,Utah,2003,1689212,1197252,70.9,1130789,66.9,66463,5.6
50,Vermont,2003,487922,346380,71.0,331239,67.9,15141,4.4
51,Virginia,2003,5518252,3772549,68.4,3609335,65.4,163214,4.3
53,Washington,2003,4660988,3136253,67.3,2910008,62.4,226245,7.2
54,West Virginia,2003,1431582,791841,55.3,739896,51.7,51945,6.6
55,Wisconsin,2003,4210386,3045298,72.3,2873956,68.3,171342,5.6
56,Wyoming,2003,382581,272804,71.3,260995,68.2,11809,4.3
1,Alabama,2004,3444085,2138306,62.1,2018783,58.6,119523,5.6
2,Alaska,2004,470999,337469,71.6,312394,66.3,25075,7.4
4,Arizona,2004,4304036,2788618,64.8,2649564,61.6,139054,5.0
5,Arkansas,2004,2087587,1302378,62.4,1229546,58.9,72832,5.6
6,California,2004,26503320,17374506,65.6,16293555,61.5,1080951,6.2
8,Colorado,2004,3491060,2539389,72.7,2397588,68.7,141801,5.6
9,Connecticut,2004,2664644,1777510,66.7,1687121,63.3,90389,5.1
10,Delaware,2004,632720,421093,66.6,402992,63.7,18101,4.3
11,District of Columbia,2004,463326,313735,67.7,288323,62.2,25412,8.1
12,Florida,2004,13558863,8347316,61.6,8033591,59.2,313725,3.8
13,Georgia,2004,6589698,4464780,67.8,4236301,64.3,228479,5.1
15,Hawaii,2004,941335,611752,65.0,591594,62.8,20158,3.3
16,Idaho,2004,1028370,702872,68.3,668638,65.0,34234,4.9
17,Illinois,2004,9559591,6348716,66.4,5955739,62.3,392977,6.2
18,Indiana,2004,4715526,3165247,67.1,2993991,63.5,171256,5.4
19,Iowa,2004,2263148,1607438,71.0,1534634,67.8,72804,4.5
20,Kansas,2004,2052157,1458910,71.1,1378355,67.2,80555,5.5
21,Kentucky,2004,3176063,1969935,62.0,1861750,58.6,108185,5.5
22,Louisiana,2004,3341006,2030415,60.8,1914521,57.3,115894,5.7
23,Maine,2004,1035627,685989,66.2,654082,63.2,31907,4.7
24,Maryland,2004,4206817,2885111,68.6,2752186,65.4,132925,4.6
25,Massachusetts,2004,5043901,3400830,67.4,3226991,64.0,173839,5.1
26,Michigan,2004,7706420,5056148,65.6,4703962,61.0,352186,7.0
27,Minnesota,2004,3893414,2893478,74.3,2760746,70.9,132732,4.6
28,Mississippi,2004,2135239,1314982,61.6,1234123,57.8,80859,6.1
29,Missouri,2004,4386582,2995924,68.3,2819803,64.3,176121,5.9
30,Montana,2004,718057,478226,66.6,456674,63.6,21552,4.5
31,Nebraska,2004,1315032,973636,74.0,935722,71.2,37914,3.9
32,Nevada,2004,1756312,1178651,67.1,1126205,64.1,52446,4.4
33,New Hampshire,2004,1007298,715495,71.0,688271,68.3,27224,3.8
34,New Jersey,2004,6602607,4348048,65.9,4134064,62.6,213984,4.9
35,New Mexico,2004,1413287,890462,63.0,841002,59.5,49460,5.6
36,New York,2004,14920093,9359930,62.7,8816050,59.1,543880,5.8
37,North Carolina,2004,6452249,4287954,66.5,4036223,62.6,251731,5.9
38,North Dakota,2004,489446,353652,72.3,341694,69.8,11958,3.4
39,Ohio,2004,8784378,5853714,66.6,5487218,62.5,366496,6.3
40,Oklahoma,2004,2638115,1690505,64.1,1610799,61.1,79706,4.7
41,Oregon,2004,2781851,1845407,66.3,1709561,61.5,135846,7.4
42,Pennsylvania,2004,9649682,6212828,64.4,5878607,60.9,334221,5.4
44,Rhode Island,2004,837494,555679,66.4,526489,62.9,29190,5.3
45,South Carolina,2004,3178645,2043864,64.3,1891722,59.5,152142,7.4
46,South Dakota,2004,582859,425953,73.1,410618,70.4,15335,3.6
47,Tennessee,2004,4541581,2897792,63.8,2742911,60.4,154881,5.3
48,Texas,2004,16322712,10998258,67.4,10336114,63.3,662144,6.0
49,Utah,2004,1730928,1231740,71.2,1170046,67.6,61694,5.0
50,Vermont,2004,491813,347352,70.6,334555,68.0,12797,3.7
51,Virginia,2004,5615773,3814529,67.9,3658421,65.1,156108,4.1
53,Washington,2004,4737670,3189389,67.3,2988316,63.1,201073,6.3
54,West Virginia,2004,1432844,789527,55.1,743989,51.9,45538,5.8
55,Wisconsin,2004,4247547,3034621,71.4,2883573,67.9,151048,5.0
56,Wyoming,2004,386204,274736,71.1,264187,68.4,10549,3.8
1,Alabama,2005,3477391,2140356,61.6,2045234,58.8,95122,4.4
2,Alaska,2005,480222,344157,71.7,320273,66.7,23884,6.9
4,Arizona,2005,4465451,2862517,64.1,2729018,61.1,133499,4.7
5,Arkansas,2005,2112848,1333880,63.1,1263663,59.8,70217,5.3
6,California,2005,26761750,17537931,65.5,16593622,62.0,944309,5.4
8,Colorado,2005,3548120,2572382,72.5,2442134,68.8,130248,5.1
9,Connecticut,2005,2677266,1794301,67.0,1707935,63.8,86366,4.8
10,Delaware,2005,644982,433375,67.2,413828,64.2,19547,4.5
11,District of Columbia,2005,466613,318130,68.2,295907,63.4,22223,7.0
12,Florida,2005,13894684,8647279,62.2,8400346,60.5,246933,2.9
13,Georgia,2005,6747800,4598159,68.1,4336264,64.3,261895,5.7
15,Hawaii,2005,951366,625530,65.8,607853,63.9,17677,2.8
16,Idaho,2005,1056225,730354,69.1,701400,66.4,28954,4.0
17,Illinois,2005,9611488,6410767,66.7,6044685,62.9,366082,5.7
18,Indiana,2005,4752908,3202215,67.4,3029258,63.7,172957,5.4
19,Iowa,2005,2275361,1628510,71.6,1558522,68.5,69988,4.3
20,Kansas,2005,2067011,1458767,70.6,1384654,67.0,74113,5.1
21,Kentucky,2005,3207183,1991726,62.1,1874747,58.5,116979,5.9
22,Louisiana,2005,3290373,2078215,63.2,1929492,58.6,148723,7.2
23,Maine,2005,1043211,695280,66.6,661176,63.4,34104,4.9
24,Maryland,2005,4253903,2931581,68.9,2799960,65.8,131621,4.5
25,Massachusetts,2005,5063714,3385536,66.9,3222953,63.6,162583,4.8
26,Michigan,2005,7736940,5069602,65.5,4725701,61.1,343901,6.8
27,Minnesota,2005,3928817,2880908,73.3,2762419,70.3,118489,4.1
28,Mississippi,2005,2143324,1317407,61.5,1217359,56.8,100048,7.6
29,Missouri,2005,4435045,3011096,67.9,2847795,64.2,163301,5.4
30,Montana,2005,728189,485546,66.7,465728,64.0,19818,4.1
31,Nebraska,2005,1324178,972759,73.5,935914,70.7,36845,3.8
32,Nevada,2005,1819152,1228449,67.5,1177587,64.7,50862,4.1
33,New Hampshire,2005,1019428,726101,71.2,699666,68.6,26435,3.6
34,New Jersey,2005,6630669,4387304,66.2,4192396,63.2,194908,4.4
35,New Mexico,2005,1436753,906007,63.1,858722,59.8,47285,5.2
36,New York,2005,15008243,9455488,63.0,8986176,59.9,469312,5.0
37,North Carolina,2005,6571000,4348830,66.2,4105112,62.5,243718,5.6
38,North Dakota,2005,491659,356385,72.5,344595,70.1,11790,3.3
39,Ohio,2005,8819792,5880691,66.7,5531429,62.7,349262,5.9
40,Oklahoma,2005,2658130,1709289,64.3,1635004,61.5,74285,4.3
41,Oregon,2005,2823513,1848897,65.5,1734710,61.4,114187,6.2
42,Pennsylvania,2005,9702277,6256642,64.5,5943887,61.3,312755,5.0
44,Rhode Island,2005,837143,563439,67.3,534535,63.9,28904,5.1
45,South Carolina,2005,3234049,2071111,64.0,1919644,59.4,151467,7.3
46,South Dakota,2005,589510,429361,72.8,414088,70.2,15273,3.6
47,Tennessee,2005,4610117,2898490,62.9,2738224,59.4,160266,5.5
48,Texas,2005,16623005,11172694,67.2,10561373,63.5,611321,5.5
49,Utah,2005,1777777,1280653,72.0,1228827,69.1,51826,4.0
50,Vermont,2005,495490,349521,70.5,337407,68.1,12114,3.5
51,Virginia,2005,5705956,3906549,68.5,3756587,65.8,149962,3.8
53,Washington,2005,4817314,3259772,67.7,3077058,63.9,182714,5.6
54,West Virginia,2005,1435076,794557,55.4,751202,52.3,43355,5.5
55,Wisconsin,2005,4285261,3029662,70.7,2885671,67.3,143991,4.8
56,Wyoming,2005,389945,279083,71.6,269172,69.0,9911,3.6
1,Alabama,2006,3522273,2170007,61.6,2083207,59.1,86800,4.0
2,Alaska,2006,490049,348756,71.2,325672,66.5,23084,6.6
4,Arizona,2006,4630001,2970679,64.2,2843054,61.4,127625,4.3
5,Arkansas,2006,2142922,1346532,62.8,1276000,59.5,70532,5.2
6,California,2006,27012671,17661179,65.4,16797845,62.2,863334,4.9
8,Colorado,2006,3621632,2640452,72.9,2528550,69.8,111902,4.2
9,Connecticut,2006,2694038,1831083,68.0,1750385,65.0,80698,4.4
10,Delaware,2006,657537,443228,67.4,425995,64.8,17233,3.9
11,District of Columbia,2006,470130,320581,68.2,300323,63.9,20258,6.3
12,Florida,2006,14163723,8927098,63.0,8707158,61.5,219940,2.5
13,Georgia,2006,6914799,4713863,68.2,4474820,64.7,239043,5.1
15,Hawaii,2006,960686,635415,66.1,619362,64.5,16053,2.5
16,Idaho,2006,1086238,744475,68.5,718848,66.2,25627,3.4
17,Illinois,2006,9675598,6515687,67.3,6217917,64.3,297770,4.6
18,Indiana,2006,4796258,3235980,67.5,3075761,64.1,160219,5.0
19,Iowa,2006,2291210,1655924,72.3,1595344,69.6,60580,3.7
20,Kansas,2006,2080118,1467553,70.6,1402950,67.4,64603,4.4
21,Kentucky,2006,3245865,2026144,62.4,1910580,58.9,115564,5.7
22,Louisiana,2006,3198013,2001297,62.6,1919476,60.0,81821,4.1
23,Maine,2006,1050791,700747,66.7,667801,63.6,32946,4.7
24,Maryland,2006,4294115,2984444,69.5,2860048,66.6,124396,4.2
25,Massachusetts,2006,5092894,3411688,67.0,3251029,63.8,160659,4.7
26,Michigan,2006,7764448,5056734,65.1,4701385,60.6,355349,7.0
27,Minnesota,2006,3971808,2889613,72.8,2772171,69.8,117442,4.1
28,Mississippi,2006,2148646,1280618,59.6,1199290,55.8,81328,6.4
29,Missouri,2006,4487608,3036656,67.7,2888798,64.4,147858,4.9
30,Montana,2006,739612,495166,66.9,478726,64.7,16440,3.3
31,Nebraska,2006,1333583,971430,72.8,941941,70.6,29489,3.0
32,Nevada,2006,1883416,1291512,68.6,1239263,65.8,52249,4.0
33,New Hampshire,2006,1032458,732384,70.9,706655,68.4,25729,3.5
34,New Jersey,2006,6658162,4436646,66.6,4231848,63.6,204798,4.6
35,New Mexico,2006,1461711,914467,62.6,876100,59.9,38367,4.2
36,New York,2006,15100241,9520386,63.0,9090969,60.2,429417,4.5
37,North Carolina,2006,6721862,4461103,66.4,4232804,63.0,228299,5.1
38,North Dakota,2006,493900,362712,73.4,351410,71.2,11302,3.1
39,Ohio,2006,8859318,5957220,67.2,5635968,63.6,321252,5.4
40,Oklahoma,2006,2690292,1714440,63.7,1647518,61.2,66922,3.9
41,Oregon,2006,2876527,1881770,65.4,1780651,61.9,101119,5.4
42,Pennsylvania,2006,9767932,6297964,64.5,6002761,61.5,295203,4.7
44,Rhode Island,2006,837533,571586,68.2,541675,64.7,29911,5.2
45,South Carolina,2006,3305437,2148698,65.0,2001245,60.5,147453,6.9
46,South Dakota,2006,597236,432760,72.5,419816,70.3,12944,3.0
47,Tennessee,2006,4692392,3014749,64.2,2856079,60.9,158670,5.3
48,Texas,2006,17004846,11335112,66.7,10770786,63.3,564326,5.0
49,Utah,2006,1835540,1333278,72.6,1295285,70.6,37993,2.8
50,Vermont,2006,499415,355394,71.2,342232,68.5,13162,3.7
51,Virginia,2006,5788571,3976503,68.7,3844285,66.4,132218,3.3
53,Washington,2006,4915790,3330058,67.7,3164354,64.4,165704,5.0
54,West Virginia,2006,1440091,804910,55.9,763325,53.0,41585,5.2
55,Wisconsin,2006,4323865,3066266,70.9,2923575,67.6,142691,4.7
56,Wyoming,2006,396036,284826,71.9,276310,69.8,8516,3.0
1,Alabama,2007,3557957,2180448,61.3,2092030,58.8,88418,4.1
2,Alaska,2007,495920,350233,70.6,328309,66.2,21924,6.3
4,Arizona,2007,4760450,3018805,63.4,2905144,61.0,113661,3.8
5,Arkansas,2007,2166219,1350811,62.4,1277902,59.0,72909,5.4
6,California,2007,27274555,17910726,65.7,16955400,62.2,955326,5.3
8,Colorado,2007,3693148,2687742,72.8,2588340,70.1,99402,3.7
9,Connecticut,2007,2707895,1856008,68.5,1773047,65.5,82961,4.5
10,Delaware,2007,668101,445306,66.7,429203,64.2,16103,3.6
11,District of Columbia,2007,473306,326557,69.0,307071,64.9,19486,6.0
12,Florida,2007,14339230,9113604,63.6,8813449,61.5,300155,3.3
13,Georgia,2007,7072669,4810264,68.0,4573302,64.7,236962,4.9
15,Hawaii,2007,968365,636710,65.8,619224,63.9,17486,2.7
16,Idaho,2007,1112418,755287,67.9,732155,65.8,23132,3.1
17,Illinois,2007,9743313,6639198,68.1,6301409,64.7,337789,5.1
18,Indiana,2007,4836385,3202589,66.2,3054548,63.2,148041,4.6
19,Iowa,2007,2306017,1662155,72.1,1600507,69.4,61648,3.7
20,Kansas,2007,2096349,1485414,70.9,1422109,67.8,63305,4.3
21,Kentucky,2007,3274539,2035493,62.2,1925716,58.8,109777,5.4
22,Louisiana,2007,3288915,2026793,61.6,1943648,59.1,83145,4.1
23,Maine,2007,1056884,699753,66.2,667061,63.1,32692,4.7
24,Maryland,2007,4325591,2989317,69.1,2877994,66.5,111323,3.7
25,Massachusetts,2007,5134517,3433239,66.9,3277912,63.8,155327,4.5
26,Michigan,2007,7775228,4994841,64.2,4640173,59.7,354668,7.1
27,Minnesota,2007,4013095,2898861,72.2,2765611,68.9,133250,4.6
28,Mississippi,2007,2171648,1293338,59.6,1213549,55.9,79789,6.2
29,Missouri,2007,4532828,3058119,67.5,2902504,64.0,155615,5.1
30,Montana,2007,750440,505095,67.3,488129,65.0,16966,3.4
31,Nebraska,2007,1342436,979043,72.9,950318,70.8,28725,2.9
32,Nevada,2007,1938289,1344209,69.4,1282414,66.2,61795,4.6
33,New Hampshire,2007,1042854,737928,70.8,712023,68.3,25905,3.5
34,New Jersey,2007,6686077,4436092,66.3,4248982,63.5,187110,4.2
35,New Mexico,2007,1482766,920673,62.1,887565,59.9,33108,3.6
36,New York,2007,15191922,9511023,62.6,9088287,59.8,422736,4.4
37,North Carolina,2007,6879821,4528594,65.8,4297692,62.5,230902,5.1
38,North Dakota,2007,495854,367564,74.1,356434,71.9,11130,3.0
39,Ohio,2007,8899484,6017203,67.6,5679258,63.8,337945,5.6
40,Oklahoma,2007,2716737,1723271,63.4,1654796,60.9,68475,4.0
41,Oregon,2007,2926092,1910890,65.3,1812303,61.9,98587,5.2
42,Pennsylvania,2007,9829441,6346588,64.6,6057645,61.6,288943,4.6
44,Rhode Island,2007,837511,571086,68.2,541956,64.7,29130,5.1
45,South Carolina,2007,3374548,2155198,63.9,2024493,60.0,130705,6.1
46,South Dakota,2007,604823,436295,72.1,423910,70.1,12385,2.8
47,Tennessee,2007,4760074,3043258,63.9,2901946,61.0,141312,4.6
48,Texas,2007,17390495,11441054,65.8,10940176,62.9,500878,4.4
49,Utah,2007,1889476,1377638,72.9,1342237,71.0,35401,2.6
50,Vermont,2007,502287,353268,70.3,339367,67.6,13901,3.9
51,Virginia,2007,5857950,4039414,69.0,3906626,66.7,132788,3.3
53,Washington,2007,5005665,3401404,68.0,3244794,64.8,156610,4.6
54,West Virginia,2007,1444435,804305,55.7,765517,53.0,38788,4.8
55,Wisconsin,2007,4358161,3087598,70.8,2938876,67.4,148722,4.8
56,Wyoming,2007,403554,290748,72.0,283072,70.1,7676,2.6
1,Alabama,2008,3591892,2176854,60.6,2049579,57.1,127275,5.8
2,Alaska,2008,501689,355298,70.8,332364,66.2,22934,6.5
4,Arizona,2008,4868327,3095993,63.6,2916698,59.9,179295,5.8
5,Arkansas,2008,2186304,1357716,62.1,1284175,58.7,73541,5.4
6,California,2008,27606374,18179907,65.9,16856082,61.1,1323825,7.3
8,Colorado,2008,3767281,2734398,72.6,2601712,69.1,132686,4.9
9,Connecticut,2008,2727282,1878120,68.9,1772393,65.0,105727,5.6
10,Delaware,2008,678154,450265,66.4,427694,63.1,22571,5.0
11,District of Columbia,2008,477782,334487,70.0,311588,65.2,22899,6.8
12,Florida,2008,14477369,9156458,63.2,8636212,59.7,520246,5.7
13,Georgia,2008,7197409,4863225,67.6,4534790,63.0,328435,6.8
15,Hawaii,2008,975321,641526,65.8,615767,63.1,25759,4.0
16,Idaho,2008,1134171,759676,67.0,721828,63.6,37848,5.0
17,Illinois,2008,9811776,6652942,67.8,6222179,63.4,430763,6.5
18,Indiana,2008,4874492,3244790,66.6,3053593,62.6,191197,5.9
19,Iowa,2008,2319607,1682209,72.5,1612459,69.5,69750,4.1
20,Kansas,2008,2111166,1493365,70.7,1425022,67.5,68343,4.6
21,Kentucky,2008,3307860,2038225,61.6,1906275,57.6,131950,6.5
22,Louisiana,2008,3352739,2064692,61.6,1968676,58.7,96016,4.7
23,Maine,2008,1062381,701930,66.1,664441,62.5,37489,5.3
24,Maryland,2008,4357178,3027934,69.5,2891508,66.4,136426,4.5
25,Massachusetts,2008,5184502,3465906,66.9,3282299,63.3,183607,5.3
26,Michigan,2008,7772411,4915781,63.2,4513249,58.1,402532,8.2
27,Minnesota,2008,4050170,2914133,72.0,2756573,68.1,157560,5.4
28,Mississippi,2008,2186906,1293375,59.1,1206858,55.2,86517,6.7
29,Missouri,2008,4576051,3065251,67.0,2875600,62.8,189651,6.2
30,Montana,2008,759997,512278,67.4,488259,64.2,24019,4.7
31,Nebraska,2008,1352164,987537,73.0,955470,70.7,32067,3.2
32,Nevada,2008,1976670,1373107,69.5,1278789,64.7,94318,6.9
33,New Hampshire,2008,1051320,742881,70.7,715076,68.0,27805,3.7
34,New Jersey,2008,6722056,4495936,66.9,4251455,63.2,244481,5.4
35,New Mexico,2008,1499299,933628,62.3,893645,59.6,39983,4.3
36,New York,2008,15272352,9641100,63.1,9121271,59.7,519829,5.4
37,North Carolina,2008,7011929,4578477,65.3,4296605,61.3,281872,6.2
38,North Dakota,2008,498983,371843,74.5,360446,72.2,11397,3.1
39,Ohio,2008,8929752,6002468,67.2,5609101,62.8,393367,6.6
40,Oklahoma,2008,2743197,1740886,63.5,1678409,61.2,62477,3.6
41,Oregon,2008,2970432,1946539,65.5,1825256,61.4,121283,6.2
42,Pennsylvania,2008,9888397,6439786,65.1,6096818,61.7,342968,5.3
44,Rhode Island,2008,838434,568229,67.8,525187,62.6,43042,7.6
45,South Carolina,2008,3439974,2160084,62.8,2002903,58.2,157181,7.3
46,South Dakota,2008,611461,439212,71.8,425670,69.6,13542,3.1
47,Tennessee,2008,4821665,3060778,63.5,2862093,59.4,198685,6.5
48,Texas,2008,17740350,11677743,65.8,11110499,62.6,567244,4.9
49,Utah,2008,1934013,1385646,71.6,1339394,69.3,46252,3.3
50,Vermont,2008,504718,353986,70.1,337925,67.0,16061,4.5
51,Virginia,2008,5926737,4128589,69.7,3952723,66.7,175866,4.3
53,Washington,2008,5089154,3474043,68.3,3291664,64.7,182379,5.2
54,West Virginia,2008,1448678,806254,55.7,768294,53.0,37960,4.7
55,Wisconsin,2008,4388989,3098931,70.6,2945874,67.1,153057,4.9
56,Wyoming,2008,410860,296620,72.2,287909,70.1,8711,2.9
1,Alabama,2009,3621410,2156593,59.6,1938784,53.5,217809,10.1
2,Alaska,2009,511902,359379,70.2,330718,64.6,28661,8.0
4,Arizona,2009,4951436,3128891,63.2,2826426,57.1,302465,9.7
5,Arkansas,2009,2203566,1353340,61.4,1248691,56.7,104649,7.7
6,California,2009,27946731,18305953,65.5,16193122,57.9,2112831,11.5
8,Colorado,2009,3838336,2730604,71.1,2515483,65.5,215121,7.9
9,Connecticut,2009,2746833,1888374,68.7,1731361,63.0,157013,8.3
10,Delaware,2009,686095,438383,63.9,401718,58.6,36665,8.4
11,District of Columbia,2009,486105,338113,69.6,304277,62.6,33836,10.0
12,Florida,2009,14589442,8987789,61.6,8127251,55.7,860538,9.6
13,Georgia,2009,7300589,4792150,65.6,4292830,58.8,499320,10.4
15,Hawaii,2009,981691,631970,64.4,589798,60.1,42172,6.7
16,Idaho,2009,1149973,763633,66.4,696832,60.6,66801,8.7
17,Illinois,2009,9877039,6601620,66.8,5928539,60.0,673081,10.2
18,Indiana,2009,4907391,3216535,65.5,2880173,58.7,336362,10.5
19,Iowa,2009,2333606,1677059,71.9,1569561,67.3,107498,6.4
20,Kansas,2009,2128661,1512572,71.1,1408142,66.2,104430,6.9
21,Kentucky,2009,3328976,2064847,62.0,1842085,55.3,222762,10.8
22,Louisiana,2009,3388954,2067873,61.0,1927200,56.9,140673,6.8
23,Maine,2009,1064932,697698,65.5,639142,60.0,58556,8.4
24,Maryland,2009,4397392,3049869,69.4,2819397,64.1,230472,7.6
25,Massachusetts,2009,5237356,3470431,66.3,3189506,60.9,280925,8.1
26,Michigan,2009,7771824,4860036,62.5,4221462,54.3,638574,13.1
27,Minnesota,2009,4083410,2932056,71.8,2699974,66.1,232082,7.9
28,Mississippi,2009,2199696,1268505,57.7,1149831,52.3,118674,9.4
29,Missouri,2009,4610127,3061704,66.4,2784890,60.4,276814,9.0
30,Montana,2009,767110,502593,65.5,466778,60.8,35815,7.1
31,Nebraska,2009,1363273,987855,72.5,941903,69.1,45952,4.7
32,Nevada,2009,1999624,1367367,68.4,1207052,60.4,160315,11.7
33,New Hampshire,2009,1057314,739802,70.0,694362,65.7,45440,6.1
34,New Jersey,2009,6766177,4540303,67.1,4133366,61.1,406937,9.0
35,New Mexico,2009,1516254,928373,61.2,862687,56.9,65686,7.1
36,New York,2009,15354331,9664010,62.9,8853905,57.7,810105,8.4
37,North Carolina,2009,7117828,4613198,64.8,4104074,57.7,509124,11.0
38,North Dakota,2009,503717,370364,73.5,355736,70.6,14628,3.9
39,Ohio,2009,8953903,5904847,65.9,5304803,59.2,600044,10.2
40,Oklahoma,2009,2774079,1769447,63.8,1653357,59.6,116090,6.6
41,Oregon,2009,3008002,1968365,65.4,1755156,58.3,213209,10.8
42,Pennsylvania,2009,9939374,6400238,64.4,5890073,59.3,510165,8.0
44,Rhode Island,2009,841735,571203,67.9,505930,60.1,65273,11.4
45,South Carolina,2009,3490448,2166737,62.1,1919307,55.0,247430,11.4
46,South Dakota,2009,617610,441300,71.5,421123,68.2,20177,4.6
47,Tennessee,2009,4868441,3032658,62.3,2725134,56.0,307524,10.1
48,Texas,2009,18091029,11944138,66.0,11043167,61.0,900971,7.5
49,Utah,2009,1972474,1373841,69.7,1274210,64.6,99631,7.3
50,Vermont,2009,507164,359282,70.8,337018,66.5,22264,6.2
51,Virginia,2009,6000845,4136186,68.9,3853351,64.2,282835,6.8
53,Washington,2009,5174102,3463713,66.9,3176729,61.4,286984,8.3
54,West Virginia,2009,1453261,811270,55.8,743870,51.2,67400,8.3
55,Wisconsin,2009,4417134,3112494,70.5,2833292,64.1,279202,9.0
56,Wyoming,2009,418116,299893,71.7,281123,67.2,18770,6.3
1,Alabama,2010,3690247,2197028,59.5,1968824,53.4,228204,10.4
2,Alaska,2010,518527,361707,69.8,332185,64.1,29522,8.2
4,Arizona,2010,4896820,3096316,63.2,2777404,56.7,318912,10.3
5,Arkansas,2010,2232732,1353635,60.6,1247059,55.9,106576,7.9
6,California,2010,28532316,18370536,64.4,16078454,56.4,2292082,12.5
8,Colorado,2010,3869708,2715723,70.2,2466996,63.8,248727,9.2
9,Connecticut,2010,2798201,1911289,68.3,1728121,61.8,183168,9.6
10,Delaware,2010,700898,436196,62.2,398388,56.8,37808,8.7
11,District of Columbia,2010,502917,346707,68.9,312132,62.1,34575,10.0
12,Florida,2010,14940260,9147107,61.2,8155401,54.6,991706,10.8
13,Georgia,2010,7322355,4709781,64.3,4207266,57.5,502515,10.7
15,Hawaii,2010,1030162,648549,63.0,604210,58.7,44339,6.8
16,Idaho,2010,1165430,762147,65.4,695265,59.7,66882,8.8
17,Illinois,2010,9905097,6612433,66.8,5918202,59.7,694231,10.5
18,Indiana,2010,4962815,3175885,64.0,2854843,57.5,321042,10.1
19,Iowa,2010,2358177,1674411,71.0,1571960,66.7,102451,6.1
20,Kansas,2010,2148695,1500463,69.8,1396172,65.0,104291,7.0
21,Kentucky,2010,3350086,2065023,61.6,1852302,55.3,212721,10.3
22,Louisiana,2010,3437871,2084462,60.6,1927720,56.1,156742,7.5
23,Maine,2010,1073083,697832,65.0,638984,59.5,58848,8.4
24,Maryland,2010,4488288,3078368,68.6,2836945,63.2,241423,7.8
25,Massachusetts,2010,5252272,3479304,66.2,3198617,60.9,280687,8.1
26,Michigan,2010,7739421,4754799,61.4,4173946,53.9,580853,12.2
27,Minnesota,2010,4115655,2940696,71.5,2722623,66.2,218073,7.4
28,Mississippi,2010,2228132,1309128,58.8,1176938,52.8,132190,10.1
29,Missouri,2010,4629450,3043249,65.7,2753910,59.5,289339,9.5
30,Montana,2010,777255,500895,64.4,464808,59.8,36087,7.2
31,Nebraska,2010,1386390,992009,71.6,945195,68.2,46814,4.7
32,Nevada,2010,2061293,1358860,65.9,1171879,56.9,186981,13.8
33,New Hampshire,2010,1055691,739340,70.0,694132,65.8,45208,6.1
34,New Jersey,2010,6860979,4559778,66.5,4118982,60.0,440796,9.7
35,New Mexico,2010,1560087,928862,59.5,856602,54.9,72260,7.8
36,New York,2010,15382860,9630297,62.6,8790607,57.1,839690,8.7
37,North Carolina,2010,7295065,4633695,63.5,4135783,56.7,497912,10.7
38,North Dakota,2010,521042,379062,72.8,365041,70.1,14021,3.7
39,Ohio,2010,8970327,5871473,65.5,5267304,58.7,604169,10.3
40,Oklahoma,2010,2832710,1765708,62.3,1650502,58.3,115206,6.5
41,Oregon,2010,3034354,1991749,65.6,1778034,58.6,213715,10.7
42,Pennsylvania,2010,10049131,6360605,63.3,5838498,58.1,522107,8.2
44,Rhode Island,2010,842735,571505,67.8,504957,59.9,66548,11.6
45,South Carolina,2010,3564619,2174535,61.0,1928442,54.1,246093,11.3
46,South Dakota,2010,619307,443618,71.6,421815,68.1,21803,4.9
47,Tennessee,2010,4925390,3093118,62.8,2789056,56.6,304062,9.8
48,Texas,2010,18567149,12260100,66.0,11255444,60.6,1004656,8.2
49,Utah,2010,1970916,1350173,68.5,1242907,63.1,107266,7.9
50,Vermont,2010,507845,359692,70.8,336920,66.3,22772,6.3
51,Virginia,2010,6144283,4163293,67.8,3858466,62.8,304827,7.3
53,Washington,2010,5245864,3458451,65.9,3142109,59.9,316342,9.1
54,West Virginia,2010,1476457,810101,54.9,739891,50.1,70210,8.7
55,Wisconsin,2010,4435706,3082935,69.5,2820620,63.6,262315,8.5
56,Wyoming,2010,430897,301893,70.1,280953,65.2,20940,6.9
1,Alabama,2011,3725085,2202337,59.1,1991379,53.5,210958,9.6
2,Alaska,2011,528560,364599,69.0,336312,63.6,28287,7.8
4,Arizona,2011,4926325,3051937,62.0,2763761,56.1,288176,9.4
5,Arkansas,2011,2254423,1357819,60.2,1250431,55.5,107388,7.9
6,California,2011,28952845,18406756,63.6,16220602,56.0,2186154,11.9
8,Colorado,2011,3925294,2730262,69.6,2493472,63.5,236790,8.7
9,Connecticut,2011,2829089,1914449,67.7,1741971,61.6,172478,9.0
10,Delaware,2011,711380,443971,62.4,410229,57.7,33742,7.6
11,District of Columbia,2011,516884,352193,68.1,316372,61.2,35821,10.2
12,Florida,2011,15209663,9260348,60.9,8334119,54.8,926229,10.0
13,Georgia,2011,7381037,4739281,64.2,4258833,57.7,480448,10.1
15,Hawaii,2011,1055845,660634,62.6,615470,58.3,45164,6.8
16,Idaho,2011,1179092,764205,64.8,701660,59.5,62545,8.2
17,Illinois,2011,9949849,6567531,66.0,5925787,59.6,641744,9.8
18,Indiana,2011,5002729,3189011,63.7,2904397,58.1,284614,8.9
19,Iowa,2011,2375851,1670056,70.3,1575767,66.3,94289,5.6
20,Kansas,2011,2161752,1498000,69.3,1402198,64.9,95802,6.4
21,Kentucky,2011,3371493,2061500,61.1,1868168,55.4,193332,9.4
22,Louisiana,2011,3477805,2080525,59.8,1926038,55.4,154487,7.4
23,Maine,2011,1079356,698979,64.8,644967,59.8,54012,7.7
24,Maryland,2011,4553235,3097300,68.0,2870857,63.1,226443,7.3
25,Massachusetts,2011,5295565,3484135,65.8,3232458,61.0,251677,7.2
26,Michigan,2011,7755122,4668979,60.2,4201785,54.2,467194,10.0
27,Minnesota,2011,4150150,2952527,71.1,2760400,66.5,192127,6.5
28,Mississippi,2011,2245128,1345990,60.0,1214638,54.1,131352,9.8
29,Missouri,2011,4648959,3032960,65.2,2770662,59.6,262298,8.6
30,Montana,2011,784511,501065,63.9,467786,59.6,33279,6.6
31,Nebraska,2011,1399914,1003635,71.7,959325,68.5,44310,4.4
32,Nevada,2011,2092674,1360791,65.0,1179653,56.4,181138,13.3
33,New Hampshire,2011,1060141,736785,69.5,696591,65.7,40194,5.5
34,New Jersey,2011,6916237,4561786,66.0,4134708,59.8,427078,9.4
35,New Mexico,2011,1583448,925108,58.4,858165,54.2,66943,7.2
36,New York,2011,15474264,9537752,61.6,8741662,56.5,796090,8.3
37,North Carolina,2011,7416868,4657873,62.8,4180071,56.4,477802,10.3
38,North Dakota,2011,533220,387383,72.6,374434,70.2,12949,3.3
39,Ohio,2011,8996691,5773480,64.2,5263728,58.5,509752,8.8
40,Oklahoma,2011,2867951,1767056,61.6,1668235,58.2,98821,5.6
41,Oregon,2011,3066901,1995931,65.1,1804257,58.8,191674,9.6
42,Pennsylvania,2011,10119106,6381749,63.1,5886748,58.2,495001,7.8
44,Rhode Island,2011,844463,562061,66.6,500109,59.2,61952,11.0
45,South Carolina,2011,3612048,2185171,60.5,1957493,54.2,227678,10.4
46,South Dakota,2011,623838,445866,71.5,425367,68.2,20499,4.6
47,Tennessee,2011,4973466,3117492,62.7,2833278,57.0,284214,9.1
48,Texas,2011,18967568,12499595,65.9,11498869,60.6,1000726,8.0
49,Utah,2011,1991465,1341427,67.4,1246797,62.6,94630,7.1
50,Vermont,2011,510272,357676,70.1,337779,66.2,19897,5.6
51,Virginia,2011,6243509,4205184,67.4,3929008,62.9,276176,6.6
53,Washington,2011,5311367,3437871,64.7,3144459,59.2,293412,8.5
54,West Virginia,2011,1486488,806568,54.3,743346,50.0,63222,7.8
55,Wisconsin,2011,4457584,3072157,68.9,2839987,63.7,232170,7.6
56,Wyoming,2011,437132,302932,69.3,284273,65.0,18659,6.2
1,Alabama,2012,3745693,2178508,58.2,2000848,53.4,177660,8.2
2,Alaska,2012,534987,364153,68.1,337834,63.1,26319,7.2
4,Arizona,2012,5006638,3054343,61.0,2799634,55.9,254709,8.3
5,Arkansas,2012,2266990,1349888,59.5,1251883,55.2,98005,7.3
6,California,2012,29295636,18484881,63.1,16541039,56.5,1943842,10.5
8,Colorado,2012,3993645,2749192,68.8,2529785,63.3,219407,8.0
9,Connecticut,2012,2845442,1887545,66.3,1729687,60.8,157858,8.4
10,Delaware,2012,719197,445962,62.0,414489,57.6,31473,7.1
11,District of Columbia,2012,528147,365176,69.1,332412,62.9,32764,9.0
12,Florida,2012,15438001,9335727,60.5,8529063,55.2,806664,8.6
13,Georgia,2012,7476643,4770618,63.8,4339369,58.0,431249,9.0
15,Hawaii,2012,1065644,650415,61.0,611985,57.4,38430,5.9
16,Idaho,2012,1193211,772112,64.7,714969,59.9,57143,7.4
17,Illinois,2012,9992930,6583689,65.9,5989454,59.9,594235,9.0
18,Indiana,2012,5032521,3172556,63.0,2911925,57.9,260631,8.2
19,Iowa,2012,2389698,1660180,69.5,1576236,66.0,83944,5.1
20,Kansas,2012,2174287,1490808,68.6,1405638,64.6,85170,5.7
21,Kentucky,2012,3389583,2060084,60.8,1891109,55.8,168975,8.2
22,Louisiana,2012,3502627,2089644,59.7,1948630,55.6,141014,6.7
23,Maine,2012,1082405,700730,64.7,650315,60.1,50415,7.2
24,Maryland,2012,4601141,3120947,67.8,2906518,63.2,214429,6.9
25,Massachusetts,2012,5351700,3506457,65.5,3271256,61.1,235201,6.7
26,Michigan,2012,7791752,4685462,60.1,4261963,54.7,423499,9.0
27,Minnesota,2012,4184426,2949770,70.5,2783181,66.5,166589,5.6
28,Mississippi,2012,2254011,1330450,59.0,1213245,53.8,117205,8.8
29,Missouri,2012,4670471,3004347,64.3,2789025,59.7,215322,7.2
30,Montana,2012,791192,506441,64.0,477056,60.3,29385,5.8
31,Nebraska,2012,1410901,1012807,71.8,973448,69.0,39359,3.9
32,Nevada,2012,2122954,1366208,64.4,1207733,56.9,158475,11.6
33,New Hampshire,2012,1068654,740796,69.3,700448,65.5,40348,5.4
34,New Jersey,2012,6947898,4576286,65.9,4147221,59.7,429065,9.4
35,New Mexico,2012,1593231,928762,58.3,863937,54.2,64825,7.0
36,New York,2012,15564711,9602599,61.7,8775083,56.4,827516,8.6
37,North Carolina,2012,7504450,4720203,62.9,4271383,56.9,448820,9.5
38,North Dakota,2012,544583,395490,72.6,383888,70.5,11602,2.9
39,Ohio,2012,9023547,5712475,63.3,5290392,58.6,422083,7.4
40,Oklahoma,2012,2894377,1794901,62.0,1703624,58.9,91277,5.1
41,Oregon,2012,3098061,1964662,63.4,1791248,57.8,173414,8.8
42,Pennsylvania,2012,10156562,6449023,63.5,5955409,58.6,493614,7.7
44,Rhode Island,2012,848001,560204,66.1,502897,59.3,57307,10.2
45,South Carolina,2012,3655515,2190203,59.9,1992957,54.5,197246,9.0
46,South Dakota,2012,631724,447056,70.8,428943,67.9,18113,4.1
47,Tennessee,2012,5020351,3096322,61.7,2849727,56.8,246595,8.0
48,Texas,2012,19328315,12639465,65.4,11794975,61.0,844490,6.7
49,Utah,2012,2025840,1348557,66.6,1284149,63.4,64408,4.8
50,Vermont,2012,511492,353947,69.2,336899,65.9,17048,4.8
51,Virginia,2012,6319657,4217529,66.7,3967151,62.8,250378,5.9
53,Washington,2012,5380521,3468738,64.5,3203294,59.5,265444,7.7
54,West Virginia,2012,1488022,808022,54.3,749587,50.4,58435,7.2
55,Wisconsin,2012,4480828,3070033,68.5,2857150,63.8,212883,6.9
56,Wyoming,2012,443928,303748,68.4,287110,64.7,16638,5.5
1,Alabama,2013,3765926,2172102,57.7,2012828,53.4,159274,7.3
2,Alaska,2013,538482,363544,67.5,338104,62.8,25440,7.0
4,Arizona,2013,5085868,3064554,60.3,2825341,55.6,239213,7.8
5,Arkansas,2013,2276882,1331609,58.5,1237609,54.4,94000,7.1
6,California,2013,29626794,18565408,62.7,16887864,57.0,1677544,9.0
8,Colorado,2013,4064989,2766140,68.0,2579568,63.5,186572,6.7
9,Connecticut,2013,2856909,1867378,65.4,1718834,60.2,148544,8.0
10,Delaware,2013,727677,443551,61.0,414215,56.9,29336,6.6
11,District of Columbia,2013,538977,374199,69.4,342609,63.6,31590,8.4
12,Florida,2013,15672642,9414664,60.1,8706060,55.5,708604,7.5
13,Georgia,2013,7559402,4750046,62.8,4363292,57.7,386754,8.1
15,Hawaii,2013,1074149,650978,60.6,620005,57.7,30973,4.8
16,Idaho,2013,1208621,777606,64.3,724545,59.9,53061,6.8
17,Illinois,2013,10027607,6556593,65.4,5961201,59.4,595392,9.1
18,Indiana,2013,5064442,3193683,63.1,2953672,58.3,240011,7.5
19,Iowa,2013,2405163,1676565,69.7,1597139,66.4,79426,4.7
20,Kansas,2013,2183614,1489395,68.2,1410470,64.6,78925,5.3
21,Kentucky,2013,3411413,2055895,60.3,1892777,55.5,163118,7.9
22,Louisiana,2013,3525455,2101974,59.6,1966755,55.8,135219,6.4
23,Maine,2013,1085150,704240,64.9,657058,60.5,47182,6.7
24,Maryland,2013,4639292,3128908,67.4,2924626,63.0,204282,6.5
25,Massachusetts,2013,5407696,3516689,65.0,3283144,60.7,233545,6.6
26,Michigan,2013,7826581,4736919,60.5,4323410,55.2,413509,8.7
27,Minnesota,2013,4218760,2961729,70.2,2812453,66.7,149276,5.0
28,Mississippi,2013,2264123,1273057,56.2,1164832,51.4,108225,8.5
29,Missouri,2013,4690656,3011198,64.2,2807115,59.8,204083,6.8
30,Montana,2013,799350,511199,64.0,483798,60.5,27401,5.4
31,Nebraska,2013,1420828,1014830,71.4,977464,68.8,37366,3.7
32,Nevada,2013,2154637,1370727,63.6,1234021,57.3,136706,10.0
33,New Hampshire,2013,1075451,743036,69.1,704023,65.5,39013,5.3
34,New Jersey,2013,6973700,4528019,64.9,4147661,59.5,380358,8.4
35,New Mexico,2013,1600998,929410,58.1,865207,54.0,64203,6.9
36,New York,2013,15639250,9632949,61.6,8880792,56.8,752157,7.8
37,North Carolina,2013,7595424,4701391,61.9,4336379,57.1,365012,7.8
38,North Dakota,2013,558633,401518,71.9,389928,69.8,11590,2.9
39,Ohio,2013,9060002,5706777,63.0,5281459,58.3,425318,7.5
40,Oklahoma,2013,2921037,1799525,61.6,1707220,58.4,92305,5.1
41,Oregon,2013,3126399,1924692,61.6,1775139,56.8,149553,7.8
42,Pennsylvania,2013,10181064,6419837,63.1,5962130,58.6,457707,7.1
44,Rhode Island,2013,850782,558747,65.7,505776,59.4,52971,9.5
45,South Carolina,2013,3704281,2197876,59.3,2034404,54.9,163472,7.4
46,South Dakota,2013,638676,447479,70.1,430834,67.5,16645,3.7
47,Tennessee,2013,5064575,3078892,60.8,2840127,56.1,238765,7.8
48,Texas,2013,19686191,12832035,65.2,12022272,61.1,809763,6.3
49,Utah,2013,2063005,1385908,67.2,1327560,64.4,58348,4.2
50,Vermont,2013,512771,350175,68.3,334684,65.3,15491,4.4
51,Virginia,2013,6383104,4238377,66.4,4002057,62.7,236320,5.6
53,Washington,2013,5441680,3460772,63.6,3230947,59.4,229825,6.6
54,West Virginia,2013,1487023,799481,53.8,745849,50.2,53632,6.7
55,Wisconsin,2013,4504761,3077801,68.3,2871988,63.8,205813,6.7
56,Wyoming,2013,448554,302201,67.4,287792,64.2,14409,4.8
1,Alabama,2014,3783191,2164715,57.2,2018705,53.4,146010,6.7
2,Alaska,2014,540373,364281,67.4,339704,62.9,24577,6.7
4,Arizona,2014,5178008,3118441,60.2,2906193,56.1,212248,6.8
5,Arkansas,2014,2287195,1327959,58.1,1249766,54.6,78193,5.9
6,California,2014,29962936,18676692,62.3,17264518,57.6,1412174,7.6
8,Colorado,2014,4142393,2800666,67.6,2661070,64.2,139596,5.0
9,Connecticut,2014,2867360,1889102,65.9,1764118,61.5,124984,6.6
10,Delaware,2014,737067,452712,61.4,427400,58.0,25312,5.6
11,District of Columbia,2014,547902,379678,69.3,350415,64.0,29263,7.7
12,Florida,2014,15947214,9546407,59.9,8931440,56.0,614967,6.4
13,Georgia,2014,7652862,4745859,62.0,4407067,57.6,338792,7.1
15,Hawaii,2014,1080245,664014,61.5,635913,58.9,28101,4.2
16,Idaho,2014,1226459,776937,63.3,742805,60.6,34132,4.4
17,Illinois,2014,10049204,6516372,64.8,6049059,60.2,467313,7.2
18,Indiana,2014,5093837,3228524,63.4,3036685,59.6,191839,5.9
19,Iowa,2014,2420070,1698718,70.2,1626676,67.2,72042,4.2
20,Kansas,2014,2194460,1494203,68.1,1426892,65.0,67311,4.5
21,Kentucky,2014,3427723,2006518,58.5,1877551,54.8,128967,6.4
22,Louisiana,2014,3546849,2141519,60.4,2007668,56.6,133851,6.3
23,Maine,2014,1089257,698035,64.1,659008,60.5,39027,5.6
24,Maryland,2014,4670634,3125017,66.9,2945911,63.1,179106,5.7
25,Massachusetts,2014,5461991,3569557,65.4,3364853,61.6,204704,5.7
26,Michigan,2014,7859938,4759720,60.6,4416017,56.2,343703,7.2
27,Minnesota,2014,4252305,2979798,70.1,2852488,67.1,127310,4.3
28,Mississippi,2014,2272489,1243934,54.7,1149277,50.6,94657,7.6
29,Missouri,2014,4713011,3035599,64.4,2848571,60.4,187028,6.2
30,Montana,2014,806981,512613,63.5,488738,60.6,23875,4.7
31,Nebraska,2014,1431323,1012727,70.8,979728,68.4,32999,3.3
32,Nevada,2014,2192083,1380084,63.0,1267424,57.8,112660,8.2
33,New Hampshire,2014,1083434,743756,68.6,711740,65.7,32016,4.3
34,New Jersey,2014,6994770,4493894,64.2,4191318,59.9,302576,6.7
35,New Mexico,2014,1605079,931950,58.1,870570,54.2,61380,6.6
36,New York,2014,15690912,9523567,60.7,8925328,56.9,598239,6.3
37,North Carolina,2014,7688413,4698287,61.1,4410647,57.4,287640,6.1
38,North Dakota,2014,570413,409503,71.8,398783,69.9,10720,2.6
39,Ohio,2014,9097253,5713176,62.8,5381787,59.2,331389,5.8
40,Oklahoma,2014,2945666,1797769,61.0,1719826,58.4,77943,4.3
41,Oregon,2014,3164439,1950128,61.6,1820202,57.5,129926,6.7
42,Pennsylvania,2014,10205656,6389059,62.6,6010075,58.9,378984,5.9
44,Rhode Island,2014,853716,556635,65.2,513406,60.1,43229,7.8
45,South Carolina,2014,3759002,2222426,59.1,2082941,55.4,139485,6.3
46,South Dakota,2014,643820,450769,70.0,435733,67.7,15036,3.3
47,Tennessee,2014,5109856,3043573,59.6,2842540,55.6,201033,6.6
48,Texas,2014,20086438,13006202,64.8,12333076,61.4,673126,5.2
49,Utah,2014,2099304,1415779,67.4,1364353,65.0,51426,3.6
50,Vermont,2014,513649,348697,67.9,334742,65.2,13955,4.0
51,Virginia,2014,6441177,4258856,66.1,4040908,62.7,217948,5.1
53,Washington,2014,5522477,3495153,63.3,3287904,59.5,207249,5.9
54,West Virginia,2014,1484923,795733,53.6,743955,50.1,51778,6.5
55,Wisconsin,2014,4526945,3077981,68.0,2913764,64.4,164217,5.3
56,Wyoming,2014,449700,302865,67.3,289694,64.4,13171,4.3
1,Alabama,2015,3799373,2152295,56.6,2020443,53.2,131852,6.1
2,Alaska,2015,542685,362425,66.8,339604,62.6,22821,6.3
4,Arizona,2015,5276145,3184445,60.4,2990545,56.7,193900,6.1
5,Arkansas,2015,2299074,1339301,58.3,1272785,55.4,66516,5.0
6,California,2015,30283673,18824141,62.2,17647409,58.3,1176732,6.3
8,Colorado,2015,4233776,2825761,66.7,2719997,64.2,105764,3.7
9,Connecticut,2015,2872222,1892087,65.9,1785788,62.2,106299,5.6
10,Delaware,2015,746043,462752,62.0,440555,59.1,22197,4.8
11,District of Columbia,2015,557243,388446,69.7,361556,64.9,26890,6.9
12,Florida,2015,16266345,9639737,59.3,9106772,56.0,532965,5.5
13,Georgia,2015,7762111,4734088,61.0,4446515,57.3,287573,6.1
15,Hawaii,2015,1086642,670594,61.7,647616,59.6,22978,3.4
16,Idaho,2015,1246558,795014,63.8,764121,61.3,30893,3.9
17,Illinois,2015,10052540,6511797,64.8,6119934,60.9,391863,6.0
18,Indiana,2015,5117280,3266392,63.8,3109791,60.8,156601,4.8
19,Iowa,2015,2431480,1700549,69.9,1637467,67.3,63082,3.7
20,Kansas,2015,2204743,1493782,67.8,1431533,64.9,62249,4.2
21,Kentucky,2015,3443534,1979641,57.5,1876009,54.5,103632,5.2
22,Louisiana,2015,3568063,2150050,60.3,2015081,56.5,134969,6.3
23,Maine,2015,1091324,687859,63.0,657550,60.3,30309,4.4
24,Maryland,2015,4697561,3139988,66.8,2983083,63.5,156905,5.0
25,Massachusetts,2015,5504919,3589409,65.2,3417296,62.1,172113,4.8
26,Michigan,2015,7884087,4760207,60.4,4501816,57.1,258391,5.4
27,Minnesota,2015,4282726,3005414,70.2,2891673,67.5,113741,3.8
28,Mississippi,2015,2278953,1260015,55.3,1178018,51.7,81997,6.5
29,Missouri,2015,4735158,3057859,64.6,2901467,61.3,156392,5.1
30,Montana,2015,814805,517901,63.6,495725,60.8,22176,4.3
31,Nebraska,2015,1440994,1011666,70.2,981326,68.1,30340,3.0
32,Nevada,2015,2235028,1396761,62.5,1301094,58.2,95667,6.8
33,New Hampshire,2015,1089562,746317,68.5,720832,66.2,25485,3.4
34,New Jersey,2015,7012397,4494606,64.1,4237876,60.4,256730,5.7
35,New Mexico,2015,1610774,938300,58.3,876206,54.4,62094,6.6
36,New York,2015,15718035,9536519,60.7,9035989,57.5,500530,5.2
37,North Carolina,2015,7792799,4763821,61.1,4493882,57.7,269939,5.7
38,North Dakota,2015,580163,410764,70.8,399296,68.8,11468,2.8
39,Ohio,2015,9127141,5710776,62.6,5427850,59.5,282926,5.0
40,Oklahoma,2015,2971677,1829046,61.5,1750501,58.9,78545,4.3
41,Oregon,2015,3214603,1979475,61.6,1871286,58.2,108189,5.5
42,Pennsylvania,2015,10218363,6423155,62.9,6076402,59.5,346753,5.4
44,Rhode Island,2015,855938,555272,64.9,521767,61.0,33505,6.0
45,South Carolina,2015,3822409,2267837,59.3,2134087,55.8,133750,5.9
46,South Dakota,2015,648268,453091,69.9,439293,67.8,13798,3.0
47,Tennessee,2015,5159199,3074216,59.6,2902684,56.3,171532,5.6
48,Texas,2015,20509247,13090961,63.8,12503464,61.0,587497,4.5
49,Utah,2015,2140901,1453457,67.9,1401945,65.5,51512,3.5
50,Vermont,2015,514884,346512,67.3,334262,64.9,12250,3.5
51,Virginia,2015,6495053,4233981,65.2,4048081,62.3,185900,4.4
53,Washington,2015,5619383,3554826,63.3,3361249,59.8,193577,5.4
54,West Virginia,2015,1480493,791526,53.5,739455,49.9,52071,6.6
55,Wisconsin,2015,4545552,3084207,67.9,2947048,64.8,137159,4.4
56,Wyoming,2015,451235,301608,66.8,288894,64.0,12714,4.2
1,Alabama,2016,3816953,2155729,56.5,2029157,53.2,126572,5.9
2,Alaska,2016,546589,362017,66.2,338193,61.9,23824,6.6
4,Arizona,2016,5384442,3253468,60.4,3075851,57.1,177617,5.5
5,Arkansas,2016,2312068,1343891,58.1,1290430,55.8,53461,4.0
6,California,2016,30568839,19012017,62.2,17965407,58.8,1046610,5.5
8,Colorado,2016,4322568,2894157,67.0,2803504,64.9,90653,3.1
9,Connecticut,2016,2874830,1893200,65.9,1801390,62.7,91810,4.8
10,Delaware,2016,754335,468808,62.1,447640,59.3,21168,4.5
11,District of Columbia,2016,565140,395124,69.9,370553,65.6,24571,6.2
12,Florida,2016,16616129,9841301,59.2,9360237,56.3,481064,4.9
13,Georgia,2016,7885093,4921814,62.4,4653740,59.0,268074,5.4
15,Hawaii,2016,1093555,679121,62.1,659557,60.3,19564,2.9
16,Idaho,2016,1274370,812921,63.8,783180,61.5,29741,3.7
17,Illinois,2016,10048210,6559038,65.3,6172672,61.4,386366,5.9
18,Indiana,2016,5148022,3331821,64.7,3186420,61.9,145401,4.4
19,Iowa,2016,2442456,1703164,69.7,1642152,67.2,61012,3.6
20,Kansas,2016,2213994,1491961,67.4,1431920,64.7,60041,4.0
21,Kentucky,2016,3459892,2015645,58.3,1914479,55.3,101166,5.0
22,Louisiana,2016,3583947,2123690,59.3,1994639,55.7,129051,6.1
23,Maine,2016,1094744,693917,63.4,667723,61.0,26194,3.8
24,Maryland,2016,4715122,3155918,66.9,3020827,64.1,135091,4.3
25,Massachusetts,2016,5543887,3617498,65.3,3472327,62.6,145171,4.0
26,Michigan,2016,7917715,4848638,61.2,4606948,58.2,241690,5.0
27,Minnesota,2016,4318608,3023110,70.0,2906348,67.3,116762,3.9
28,Mississippi,2016,2285176,1271836,55.7,1196241,52.3,75595,5.9
29,Missouri,2016,4755612,3072904,64.6,2933457,61.7,139447,4.5
30,Montana,2016,824042,521736,63.3,499266,60.6,22470,4.3
31,Nebraska,2016,1452381,1016062,70.0,984966,67.8,31096,3.1
32,Nevada,2016,2279404,1414233,62.0,1332390,58.5,81843,5.8
33,New Hampshire,2016,1097720,752478,68.5,731002,66.6,21476,2.9
34,New Jersey,2016,7030113,4492821,63.9,4271201,60.8,221620,4.9
35,New Mexico,2016,1617770,944245,58.4,880515,54.4,63730,6.7
36,New York,2016,15729054,9527021,60.6,9062866,57.6,464155,4.9
37,North Carolina,2016,7911794,4844851,61.2,4598456,58.1,246395,5.1
38,North Dakota,2016,581106,411778,70.9,399001,68.7,12777,3.1
39,Ohio,2016,9158368,5754480,62.8,5464097,59.7,290383,5.0
40,Oklahoma,2016,2990341,1828055,61.1,1743225,58.3,84830,4.6
41,Oregon,2016,3279335,2042929,62.3,1946233,59.3,96696,4.7
42,Pennsylvania,2016,10232466,6458891,63.1,6114644,59.8,344247,5.3
44,Rhode Island,2016,858159,553231,64.5,524438,61.1,28793,5.2
45,South Carolina,2016,3888005,2286054,58.8,2174301,55.9,111753,4.9
46,South Dakota,2016,654760,455133,69.5,441418,67.4,13715,3.0
47,Tennessee,2016,5213936,3136399,60.2,2987679,57.3,148720,4.7
48,Texas,2016,20905007,13346836,63.8,12728898,60.9,617938,4.6
49,Utah,2016,2193627,1500137,68.4,1449981,66.1,50156,3.3
50,Vermont,2016,515410,345851,67.1,335043,65.0,10808,3.1
51,Virginia,2016,6543548,4254348,65.0,4084822,62.4,169526,4.0
53,Washington,2016,5731878,3648558,63.7,3459527,60.4,189031,5.2
54,West Virginia,2016,1474040,785104,53.3,737205,50.0,47899,6.1
55,Wisconsin,2016,4566315,3110466,68.1,2988744,65.5,121722,3.9
56,Wyoming,2016,450992,300546,66.6,284439,63.1,16107,5.4
1,Alabama,2017,3889272,2203458,56.7,2103873,54.1,99585,4.5
2,Alaska,2017,546466,360589,66.0,337108,61.7,23481,6.5
4,Arizona,2017,5341967,3240111,60.7,3079700,57.7,160411,5.0
5,Arkansas,2017,2312545,1348088,58.3,1297854,56.1,50234,3.7
6,California,2017,30804622,19185366,62.3,18258064,59.3,927302,4.8
8,Colorado,2017,4376946,2963790,67.7,2885980,65.9,77810,2.6
9,Connecticut,2017,2901376,1923711,66.3,1838833,63.4,84878,4.4
10,Delaware,2017,764025,475214,62.2,453949,59.4,21265,4.5
11,District of Columbia,2017,558148,393326,70.5,369388,66.2,23938,6.1
12,Florida,2017,16818377,9972990,59.3,9544892,56.8,428098,4.3
13,Georgia,2017,7995544,5107889,63.9,4864813,60.8,243076,4.8
15,Hawaii,2017,1120898,695303,62.0,679865,60.7,15438,2.2
16,Idaho,2017,1314456,839776,63.9,812875,61.8,26901,3.2
17,Illinois,2017,10141740,6562291,64.7,6237933,61.5,324358,4.9
18,Indiana,2017,5189801,3333693,64.2,3217049,62.0,116644,3.5
19,Iowa,2017,2465307,1697495,68.9,1645660,66.8,51835,3.1
20,Kansas,2017,2227730,1488346,66.8,1434516,64.4,53830,3.6
21,Kentucky,2017,3489934,2053398,58.8,1955234,56.0,98164,4.8
22,Louisiana,2017,3586139,2108485,58.8,2000487,55.8,107998,5.1
23,Maine,2017,1106282,703871,63.6,680164,61.5,23707,3.4
24,Maryland,2017,4799005,3243896,67.6,3114580,64.9,129316,4.0
25,Massachusetts,2017,5654177,3724520,65.9,3582389,63.4,142131,3.8
26,Michigan,2017,7999550,4911247,61.4,4685853,58.6,225394,4.6
27,Minnesota,2017,4379847,3071006,70.1,2963830,67.7,107176,3.5
28,Mississippi,2017,2284344,1272685,55.7,1206102,52.8,66583,5.2
29,Missouri,2017,4775175,3053526,63.9,2939306,61.6,114220,3.7
30,Montana,2017,836658,528441,63.2,506871,60.6,21570,4.1
31,Nebraska,2017,1473927,1023163,69.4,992740,67.4,30423,3.0
32,Nevada,2017,2308537,1444262,62.6,1372022,59.4,72240,5.0
33,New Hampshire,2017,1112624,758133,68.1,736918,66.2,21215,2.8
34,New Jersey,2017,7269751,4614953,63.5,4406151,60.6,208802,4.5
35,New Mexico,2017,1627137,948581,58.3,890988,54.8,57593,6.1
36,New York,2017,16176117,9838170,60.8,9382750,58.0,455420,4.6
37,North Carolina,2017,7932255,4865900,61.3,4646212,58.6,219688,4.5
38,North Dakota,2017,587828,415765,70.7,404901,68.9,10864,2.6
39,Ohio,2017,9236379,5818975,63.0,5529479,59.9,289496,5.0
40,Oklahoma,2017,2987388,1826272,61.1,1752733,58.7,73539,4.0
41,Oregon,2017,3327673,2075682,62.4,1991503,59.8,84179,4.1
42,Pennsylvania,2017,10357025,6485253,62.6,6161913,59.5,323340,5.0
44,Rhode Island,2017,882242,568144,64.4,542552,61.5,25592,4.5
45,South Carolina,2017,3897645,2261766,58.0,2166708,55.6,95058,4.2
46,South Dakota,2017,658460,455339,69.2,441450,67.0,13889,3.1
47,Tennessee,2017,5284932,3197032,60.5,3077515,58.2,119517,3.7
48,Texas,2017,21135080,13473991,63.8,12888025,61.0,585966,4.3
49,Utah,2017,2260156,1554352,68.8,1505413,66.6,48939,3.1
50,Vermont,2017,527814,355385,67.3,344698,65.3,10687,3.0
51,Virginia,2017,6624960,4352977,65.7,4193290,63.3,159687,3.7
53,Washington,2017,5851092,3727683,63.7,3554754,60.8,172929,4.6
54,West Virginia,2017,1467310,784744,53.5,743786,50.7,40958,5.2
55,Wisconsin,2017,4617621,3141757,68.0,3039348,65.8,102409,3.3
56,Wyoming,2017,445796,293802,65.9,281164,63.1,12638,4.3
1,Alabama,2018,3911655,2240109,57.3,2152270,55.0,87839,3.9
2,Alaska,2018,545700,355499,65.1,334068,61.2,21431,6.0
4,Arizona,2018,5434496,3325721,61.2,3166013,58.3,159708,4.8
5,Arkansas,2018,2321285,1343862,57.9,1294809,55.8,49053,3.7
6,California,2018,30963179,19289505,62.3,18469910,59.7,819595,4.2
8,Colorado,2018,4451642,3054347,68.6,2961423,66.5,92924,3.0
9,Connecticut,2018,2909955,1923872,66.1,1849370,63.6,74502,3.9
10,Delaware,2018,772933,480371,62.1,462545,59.8,17826,3.7
11,District of Columbia,2018,561591,395604,70.4,373202,66.5,22402,5.7
12,Florida,2018,17061122,10118306,59.3,9749598,57.1,368708,3.6
13,Georgia,2018,8097261,5126923,63.3,4922489,60.8,204434,4.0
15,Hawaii,2018,1124162,692457,61.6,675849,60.1,16608,2.4
16,Idaho,2018,1346386,862434,64.1,837767,62.2,24667,2.9
17,Illinois,2018,10134812,6557416,64.7,6270844,61.9,286572,4.4
18,Indiana,2018,5224191,3392579,64.9,3276805,62.7,115774,3.4
19,Iowa,2018,2474800,1711811,69.2,1667817,67.4,43994,2.6
20,Kansas,2018,2233869,1493360,66.9,1443204,64.6,50156,3.4
21,Kentucky,2018,3502248,2052877,58.6,1966186,56.1,86691,4.2
22,Louisiana,2018,3584904,2109741,58.9,2007981,56.0,101760,4.8
23,Maine,2018,1112504,700856,63.0,678584,61.0,22272,3.2
24,Maryland,2018,4823675,3270635,67.8,3146485,65.2,124150,3.8
25,Massachusetts,2018,5694039,3818769,67.1,3686198,64.7,132571,3.5
26,Michigan,2018,8029716,4944794,61.6,4739081,59.0,205713,4.2
27,Minnesota,2018,4418073,3075090,69.6,2982658,67.5,92432,3.0
28,Mississippi,2018,2280313,1268040,55.6,1205342,52.9,62698,4.9
29,Missouri,2018,4791474,3048449,63.6,2949963,61.6,98486,3.2
30,Montana,2018,845569,535140,63.3,515213,60.9,19927,3.7
31,Nebraska,2018,1484120,1036411,69.8,1006283,67.8,30128,2.9
32,Nevada,2018,2357842,1494692,63.4,1429284,60.6,65408,4.4
33,New Hampshire,2018,1120839,770469,68.7,750285,66.9,20184,2.6
34,New Jersey,2018,7311915,4604787,63.0,4420713,60.5,184074,4.0
35,New Mexico,2018,1634623,944936,57.8,898360,55.0,46576,4.9
36,New York,2018,16217662,9826126,60.6,9424212,58.1,401914,4.1
37,North Carolina,2018,8032424,4911884,61.2,4715616,58.7,196268,4.0
38,North Dakota,2018,589972,412069,69.8,402201,68.2,9868,2.4
39,Ohio,2018,9267912,5819989,62.8,5558124,60.0,261865,4.5
40,Oklahoma,2018,2997373,1831256,61.1,1771251,59.1,60005,3.3
41,Oregon,2018,3366596,2080051,61.8,1996490,59.3,83561,4.0
42,Pennsylvania,2018,10388655,6509775,62.7,6222004,59.9,287771,4.4
44,Rhode Island,2018,887694,572663,64.5,549529,61.9,23134,4.0
45,South Carolina,2018,3948448,2282022,57.8,2205356,55.9,76666,3.4
46,South Dakota,2018,663384,459202,69.2,446413,67.3,12789,2.8
47,Tennessee,2018,5342696,3257053,61.0,3143792,58.8,113261,3.5
48,Texas,2018,21443061,13714126,64.0,13178793,61.5,535333,3.9
49,Utah,2018,2312734,1584494,68.5,1538295,66.5,46199,2.9
50,Vermont,2018,530176,355343,67.0,346553,65.4,8790,2.5
51,Virginia,2018,6670343,4359053,65.3,4228274,63.4,130779,3.0
53,Washington,2018,5944441,3814538,64.2,3645992,61.3,168546,4.4
54,West Virginia,2018,1458977,793415,54.4,752602,51.6,40813,5.1
55,Wisconsin,2018,4643524,3123898,67.3,3030659,65.3,93239,3.0
56,Wyoming,2018,445661,292629,65.7,280754,63.0,11875,4.1
1,Alabama,2019,3935788,2272935,57.8,2200437,55.9,72498,3.2
2,Alaska,2019,544905,353161,64.8,333360,61.2,19801,5.6
4,Arizona,2019,5537789,3430766,62.0,3265708,59.0,165058,4.8
5,Arkansas,2019,2330750,1354936,58.1,1307510,56.1,47426,3.5
6,California,2019,31056874,19413244,62.5,18617933,59.9,795311,4.1
8,Colorado,2019,4519715,3105584,68.7,3022829,66.9,82755,2.7
9,Connecticut,2019,2913268,1938637,66.5,1868767,64.1,69870,3.6
10,Delaware,2019,782769,484657,61.9,467162,59.7,17495,3.6
11,District of Columbia,2019,563160,399857,71.0,377800,67.1,22057,5.5
12,Florida,2019,17273996,10284663,59.5,9950515,57.6,334148,3.2
13,Georgia,2019,8203811,5160512,62.9,4975975,60.7,184537,3.6
15,Hawaii,2019,1124354,686123,61.0,668774,59.5,17349,2.5
16,Idaho,2019,1381645,888504,64.3,862981,62.5,25523,2.9
17,Illinois,2019,10125894,6550295,64.7,6289513,62.1,260782,4.0
18,Indiana,2019,5259231,3404321,64.7,3291950,62.6,112371,3.3
19,Iowa,2019,2487544,1743153,70.1,1696691,68.2,46462,2.7
20,Kansas,2019,2240796,1504552,67.1,1455263,64.9,49289,3.3
21,Kentucky,2019,3515061,2068975,58.9,1983872,56.4,85103,4.1
22,Louisiana,2019,3584852,2105926,58.7,2008163,56.0,97763,4.6
23,Maine,2019,1119828,697795,62.3,677460,60.5,20335,2.9
24,Maryland,2019,4846181,3334365,68.8,3221317,66.5,113048,3.4
25,Massachusetts,2019,5725399,3841324,67.1,3725143,65.1,116181,3.0
26,Michigan,2019,8049908,4976013,61.8,4773453,59.3,202560,4.1
27,Minnesota,2019,4453257,3108682,69.8,3007374,67.5,101308,3.3
28,Mississippi,2019,2280145,1278598,56.1,1208096,53.0,70502,5.5
29,Missouri,2019,4812110,3074821,63.9,2975703,61.8,99118,3.2
30,Montana,2019,854621,543741,63.6,524686,61.4,19055,3.5
31,Nebraska,2019,1493995,1051554,70.4,1018707,68.2,32847,3.1
32,Nevada,2019,2409356,1546313,64.2,1482647,61.5,63666,4.1
33,New Hampshire,2019,1129954,780540,69.1,760516,67.3,20024,2.6
34,New Jersey,2019,7351409,4686262,63.7,4524292,61.5,161970,3.5
35,New Mexico,2019,1645584,956094,58.1,908703,55.2,47391,5.0
36,New York,2019,16238937,9853962,60.7,9474510,58.3,379452,3.9
37,North Carolina,2019,8128596,4993476,61.4,4801094,59.1,192382,3.9
38,North Dakota,2019,592785,413845,69.8,404793,68.3,9052,2.2
39,Ohio,2019,9298346,5877451,63.2,5632572,60.6,244879,4.2
40,Oklahoma,2019,3014372,1840223,61.0,1782411,59.1,57812,3.1
41,Oregon,2019,3402123,2094783,61.6,2017199,59.3,77584,3.7
42,Pennsylvania,2019,10411566,6573616,63.1,6287804,60.4,285812,4.3
44,Rhode Island,2019,891912,574346,64.4,554076,62.1,20270,3.5
45,South Carolina,2019,4002601,2324500,58.1,2259807,56.5,64693,2.8
46,South Dakota,2019,669499,464329,69.4,451353,67.4,12976,2.8
47,Tennessee,2019,5397378,3335270,61.8,3223664,59.7,111606,3.3
48,Texas,2019,21776098,13921781,63.9,13429073,61.7,492708,3.5
49,Utah,2019,2365223,1618697,68.4,1577591,66.7,41106,2.5
50,Vermont,2019,532459,353506,66.4,346016,65.0,7490,2.1
51,Virginia,2019,6718931,4414972,65.7,4292501,63.9,122471,2.8
53,Washington,2019,6029945,3933880,65.2,3766964,62.5,166916,4.2
54,West Virginia,2019,1452860,795299,54.7,755909,52.0,39390,5.0
55,Wisconsin,2019,4670191,3111729,66.6,3012828,64.5,98901,3.2
56,Wyoming,2019,447440,293320,65.6,282433,63.1,10887,3.7
1,Alabama,2020,3966036,2269672,57.2,2124409,53.6,145263,6.4
2,Alaska,2020,544846,347150,63.7,318298,58.4,28852,8.3
4,Arizona,2020,5655336,3471038,61.4,3199851,56.6,271187,7.8
5,Arkansas,2020,2345881,1346789,57.4,1263623,53.9,83166,6.2
6,California,2020,31184333,18971560,60.8,17047569,54.7,1923991,10.1
8,Colorado,2020,4588240,3088995,67.3,2880227,62.8,208768,6.8
9,Connecticut,2020,2914556,1884099,64.6,1734478,59.5,149621,7.9
10,Delaware,2020,795551,486497,61.2,449965,56.6,36532,7.5
11,District of Columbia,2020,554650,386296,69.6,355788,64.1,30508,7.9
12,Florida,2020,17516067,10113733,57.7,9292632,53.1,821101,8.1
13,Georgia,2020,8309241,5095696,61.3,4766734,57.4,328962,6.5
15,Hawaii,2020,1125256,664085,59.0,586179,52.1,77906,11.7
16,Idaho,2020,1423943,901894,63.3,852423,59.9,49471,5.5
17,Illinois,2020,10125350,6349816,62.7,5759004,56.9,590812,9.3
18,Indiana,2020,5299963,3346344,63.1,3102706,58.5,243638,7.3
19,Iowa,2020,2499928,1673589,66.9,1587341,63.5,86248,5.2
20,Kansas,2020,2253496,1503002,66.7,1415445,62.8,87557,5.8
21,Kentucky,2020,3529516,2017001,57.1,1886072,53.4,130929,6.5
22,Louisiana,2020,3591019,2064942,57.5,1887347,52.6,177595,8.6
23,Maine,2020,1128424,670595,59.4,636655,56.4,33940,5.1
24,Maryland,2020,4872205,3241086,66.5,3031031,62.2,210055,6.5
25,Massachusetts,2020,5739277,3750155,65.3,3399381,59.2,350774,9.4
26,Michigan,2020,8069823,4863008,60.3,4379122,54.3,483886,10.0
27,Minnesota,2020,4487088,3134161,69.8,2938015,65.5,196146,6.3
28,Mississippi,2020,2282017,1247029,54.6,1147391,50.3,99638,8.0
29,Missouri,2020,4839399,3037880,62.8,2851947,58.9,185933,6.1
30,Montana,2020,866547,545334,62.9,513545,59.3,31789,5.8
31,Nebraska,2020,1505301,1048389,69.6,1003443,66.7,44946,4.3
32,Nevada,2020,2459637,1506631,61.3,1302990,53.0,203641,13.5
33,New Hampshire,2020,1140447,764137,67.0,713144,62.5,50993,6.7
34,New Jersey,2020,7395273,4650326,62.9,4212389,57.0,437937,9.4
35,New Mexico,2020,1662218,931921,56.1,858350,51.6,73571,7.9
36,New York,2020,16226178,9580847,59.0,8645489,53.3,935358,9.8
37,North Carolina,2020,8224476,4839372,58.8,4491749,54.6,347623,7.2
38,North Dakota,2020,595350,409799,68.8,389415,65.4,20384,5.0
39,Ohio,2020,9335358,5754698,61.6,5280930,56.6,473768,8.2
40,Oklahoma,2020,3038592,1841349,60.6,1725318,56.8,116031,6.3
41,Oregon,2020,3440805,2107362,61.2,1947567,56.6,159795,7.6
42,Pennsylvania,2020,10458263,6514565,62.3,5933182,56.7,581383,8.9
44,Rhode Island,2020,896854,570185,63.6,517949,57.8,52236,9.2
45,South Carolina,2020,4062556,2335026,57.5,2195171,54.0,139855,6.0
46,South Dakota,2020,675726,464505,68.7,444899,65.8,19606,4.2
47,Tennessee,2020,5466862,3303230,60.4,3056709,55.9,246521,7.5
48,Texas,2020,22170937,13955332,62.9,12883803,58.1,1071529,7.7
49,Utah,2020,2426040,1647376,67.9,1567777,64.6,79599,4.8
50,Vermont,2020,535637,339810,63.4,320542,59.8,19268,5.7
51,Virginia,2020,6769955,4342950,64.2,4062417,60.0,280533,6.5
53,Washington,2020,6119477,3936084,64.3,3603370,58.9,332714,8.5
54,West Virginia,2020,1446494,779913,53.9,715637,49.5,64276,8.2
55,Wisconsin,2020,4704024,3094716,65.8,2897422,61.6,197294,6.4
56,Wyoming,2020,450627,293755,65.2,276495,61.4,17260,5.9
1,Alabama,2021,3989929,2259349,56.6,2183330,54.7,76019,3.4
2,Alaska,2021,545826,353158,64.7,330525,60.6,22633,6.4
4,Arizona,2021,5755794,3530579,61.3,3352198,58.2,178381,5.1
5,Arkansas,2021,2361849,1339665,56.7,1285329,54.4,54336,4.1
6,California,2021,31090367,18973377,61.0,17586314,56.6,1387063,7.3
8,Colorado,2021,4635455,3158144,68.1,2986238,64.4,171906,5.4
9,Connecticut,2021,2936714,1855339,63.2,1739033,59.2,116306,6.3
10,Delaware,2021,808479,493931,61.1,466770,57.7,27161,5.5
11,District of Columbia,2021,546920,378103,69.1,352468,64.4,25635,6.8
12,Florida,2021,17776346,10353311,58.2,9872517,55.5,480794,4.6
13,Georgia,2021,8397878,5179121,61.7,4977562,59.3,201559,3.9
15,Hawaii,2021,1124810,669987,59.6,629626,56.0,40361,6.0
16,Idaho,2021,1470529,925409,62.9,893169,60.7,32240,3.5
17,Illinois,2021,10082638,6366428,63.1,5980444,59.3,385984,6.1
18,Indiana,2021,5331345,3355642,62.9,3225060,60.5,130582,3.9
19,Iowa,2021,2510670,1690368,67.3,1626168,64.8,64200,3.8
20,Kansas,2021,2261148,1500677,66.4,1451204,64.2,49473,3.3
21,Kentucky,2021,3534295,2027165,57.4,1937537,54.8,89628,4.4
22,Louisiana,2021,3580022,2073572,57.9,1958087,54.7,115485,5.6
23,Maine,2021,1141890,685168,60.0,653341,57.2,31827,4.6
24,Maryland,2021,4884468,3173289,65.0,3005067,61.5,168222,5.3
25,Massachusetts,2021,5745468,3742987,65.1,3535696,61.5,207291,5.5
26,Michigan,2021,8066407,4779555,59.3,4501562,55.8,277993,5.8
27,Minnesota,2021,4503833,3039323,67.5,2924148,64.9,115175,3.8
28,Mississippi,2021,2280572,1255710,55.1,1187096,52.1,68614,5.5
29,Missouri,2021,4862659,3050028,62.7,2925218,60.2,124810,4.1
30,Montana,2021,883626,550555,62.3,531926,60.2,18629,3.4
31,Nebraska,2021,1511554,1049584,69.4,1021330,67.6,28254,2.7
32,Nevada,2021,2497185,1499499,60.0,1395651,55.9,103848,6.9
33,New Hampshire,2021,1150014,756858,65.8,731117,63.6,25741,3.4
34,New Jersey,2021,7411284,4666108,63.0,4357217,58.8,308891,6.6
35,New Mexico,2021,1670868,943382,56.5,876730,52.5,66652,7.1
36,New York,2021,16078040,9557912,59.4,8886155,55.3,671757,7.0
37,North Carolina,2021,8339111,4954783,59.4,4712866,56.5,241917,4.9
38,North Dakota,2021,596255,408900,68.6,396364,66.5,12536,3.1
39,Ohio,2021,9332099,5728769,61.4,5434815,58.2,293954,5.1
40,Oklahoma,2021,3064929,1860337,60.7,1785703,58.3,74634,4.0
41,Oregon,2021,3463707,2147611,62.0,2035428,58.8,112183,5.2
42,Pennsylvania,2021,10496024,6445362,61.4,6058976,57.7,386386,6.0
44,Rhode Island,2021,899521,571698,63.6,540182,60.1,31516,5.5
45,South Carolina,2021,4124126,2353968,57.1,2261060,54.8,92908,3.9
46,South Dakota,2021,683982,469583,68.7,457174,66.8,12409,2.6
47,Tennessee,2021,5523362,3323545,60.2,3174135,57.5,149410,4.5
48,Texas,2021,22534721,14311029,63.5,13503671,59.9,807358,5.6
49,Utah,2021,2486143,1687539,67.9,1641338,66.0,46201,2.7
50,Vermont,2021,539890,335823,62.2,323354,59.9,12469,3.7
51,Virginia,2021,6803773,4331297,63.7,4162555,61.2,168742,3.9
53,Washington,2021,6164797,3898707,63.2,3695705,59.9,203002,5.2
54,West Virginia,2021,1442066,778747,54.0,739003,51.2,39744,5.1
55,Wisconsin,2021,4716770,3099768,65.7,2981070,63.2,118698,3.8
56,Wyoming,2021,454147,289154,63.7,275748,60.7,13406,4.6
1,Alabama,2022,4013691,2286028,57.0,2226670,55.5,59358,2.6
2,Alaska,2022,546834,356799,65.2,342400,62.6,14399,4.0
4,Arizona,2022,5859772,3615161,61.7,3477033,59.3,138128,3.8
5,Arkansas,2022,2379534,1369367,57.5,1323949,55.6,45418,3.3
6,California,2022,31093752,19251974,61.9,18440895,59.3,811079,4.2
8,Colorado,2022,4680613,3200625,68.4,3103531,66.3,97094,3.0
9,Connecticut,2022,2947130,1932463,65.6,1851993,62.8,80470,4.2
10,Delaware,2022,821383,496688,60.5,474258,57.7,22430,4.5
11,District of Columbia,2022,549685,388403,70.7,370229,67.4,18174,4.7
12,Florida,2022,18134062,10762307,59.3,10449041,57.6,313266,2.9
13,Georgia,2022,8513926,5234275,61.5,5075093,59.6,159182,3.0
15,Hawaii,2022,1123667,676299,60.2,652677,58.1,23622,3.5
16,Idaho,2022,1506615,950672,63.1,925358,61.4,25314,2.7
17,Illinois,2022,10035838,6472663,64.5,6176876,61.5,295787,4.6
18,Indiana,2022,5357736,3404443,63.5,3302632,61.6,101811,3.0
19,Iowa,2022,2519424,1716894,68.1,1669933,66.3,46961,2.7
20,Kansas,2022,2267589,1504932,66.4,1464834,64.6,40098,2.7
21,Kentucky,2022,3541106,2048066,57.8,1968121,55.6,79945,3.9
22,Louisiana,2022,3560268,2088217,58.7,2011867,56.5,76350,3.7
23,Maine,2022,1152551,674875,58.6,654965,56.8,19910,3.0
24,Maryland,2022,4887139,3171513,64.9,3068700,62.8,102813,3.2
25,Massachusetts,2022,5750958,3743924,65.1,3603172,62.7,140752,3.8
26,Michigan,2022,8079178,4835966,59.9,4632539,57.3,203427,4.2
27,Minnesota,2022,4519077,3077500,68.1,2994920,66.3,82580,2.7
28,Mississippi,2022,2279804,1251022,54.9,1201880,52.7,49142,3.9
29,Missouri,2022,4882274,3061279,62.7,2984340,61.1,76939,2.5
30,Montana,2022,900481,567787,63.1,552842,61.4,14945,2.6
31,Nebraska,2022,1519307,1058927,69.7,1034091,68.1,24836,2.3
32,Nevada,2022,2532731,1549859,61.2,1466213,57.9,83646,5.4
33,New Hampshire,2022,1159452,766672,66.1,747339,64.5,19333,2.5
34,New Jersey,2022,7420969,4739804,63.9,4564113,61.5,175691,3.7
35,New Mexico,2022,1676424,947025,56.5,908870,54.2,38155,4.0
36,New York,2022,15967990,9616989,60.2,9205821,57.7,411168,4.3
37,North Carolina,2022,8467545,5159329,60.9,4970998,58.7,188331,3.7
38,North Dakota,2022,598591,414311,69.2,405580,67.8,8731,2.1
39,Ohio,2022,9339327,5741277,61.5,5510327,59.0,230950,4.0
40,Oklahoma,2022,3094170,1887040,61.0,1830061,59.1,56979,3.0
41,Oregon,2022,3466172,2176734,62.8,2085939,60.2,90795,4.2
42,Pennsylvania,2022,10490813,6479077,61.8,6196385,59.1,282692,4.4
44,Rhode Island,2022,899721,569455,63.3,551220,61.3,18235,3.2
45,South Carolina,2022,4204317,2374975,56.5,2297927,54.7,77048,3.2
46,South Dakota,2022,696215,475065,68.2,465250,66.8,9815,2.1
47,Tennessee,2022,5595306,3352030,59.9,3238559,57.9,113471,3.4
48,Texas,2022,22962733,14662558,63.9,14092833,61.4,569725,3.9
49,Utah,2022,2536616,1743054,68.7,1702674,67.1,40380,2.3
50,Vermont,2022,541744,342119,63.2,333081,61.5,9038,2.6
51,Virginia,2022,6839542,4435858,64.9,4308805,63.0,127053,2.9
53,Washington,2022,6223443,3990343,64.1,3822319,61.4,168024,4.2
54,West Virginia,2022,1435928,785115,54.7,754453,52.5,30662,3.9
55,Wisconsin,2022,4739794,3082128,65.0,2992049,63.1,90079,2.9
56,Wyoming,2022,457895,291756,63.7,281343,61.4,10413,3.6
